State,State Code,County,State FIPS,County FIPS,FIPS,Team,Color,County Population,Clinton,Trump,Total,% Clinton,% Trump,Vote Difference C-T,Vote Difference T-C,Percent Difference C-T,Percent Difference T-C
Alabama,AL,Autauga County,1,1,1001,Saints,#9f8958,55347,5908,18110,24661,0.23956855,0.734357893,-12202,12202,-0.494789343,0.494789343
Alabama,AL,Baldwin County,1,3,1003,Saints,#9f8958,203709,18409,72780,94090,0.195653098,0.77351472,-54371,54371,-0.577861622,0.577861622
Alabama,AL,Barbour County,1,5,1005,Falcons,#a71930,26489,4848,5431,10390,0.466602502,0.522714148,-583,583,-0.056111646,0.056111646
Alabama,AL,Bibb County,1,7,1007,Saints,#9f8958,22583,1874,6733,8748,0.214220393,0.769661637,-4859,4859,-0.555441244,0.555441244
Alabama,AL,Blount County,1,9,1009,Saints,#9f8958,57673,2150,22808,25384,0.084699023,0.898518752,-20658,20658,-0.813819729,0.813819729
Alabama,AL,Bullock County,1,11,1011,Falcons,#a71930,10696,3530,1139,4701,0.750904063,0.242288875,2391,-2391,0.508615188,-0.508615188
Alabama,AL,Butler County,1,13,1013,Saints,#9f8958,20154,3716,4891,8685,0.427864134,0.563154865,-1175,1175,-0.135290731,0.135290731
Alabama,AL,Calhoun County,1,15,1015,Falcons,#a71930,115620,13197,32803,47376,0.278558764,0.692396994,-19606,19606,-0.41383823,0.41383823
Alabama,AL,Chambers County,1,17,1017,Falcons,#a71930,34123,5763,7803,13778,0.418275512,0.56633764,-2040,2040,-0.148062128,0.148062128
Alabama,AL,Cherokee County,1,19,1019,Falcons,#a71930,25859,1524,8809,10503,0.1451014,0.838712749,-7285,7285,-0.693611349,0.693611349
Alabama,AL,Chilton County,1,21,1021,Saints,#9f8958,43943,2909,15068,18255,0.159353602,0.825417694,-12159,12159,-0.666064092,0.666064092
Alabama,AL,Choctaw County,1,23,1023,Saints,#9f8958,13170,3109,4102,7268,0.427765548,0.564391855,-993,993,-0.136626307,0.136626307
Alabama,AL,Clarke County,1,25,1025,Saints,#9f8958,24675,5712,7109,12936,0.441558442,0.549551639,-1397,1397,-0.107993197,0.107993197
Alabama,AL,Clay County,1,27,1027,Falcons,#a71930,13555,1234,5230,6572,0.187766281,0.795800365,-3996,3996,-0.608034084,0.608034084
Alabama,AL,Cleburne County,1,29,1029,Falcons,#a71930,15018,684,5738,6532,0.104715248,0.878444581,-5054,5054,-0.773729333,0.773729333
Alabama,AL,Coffee County,1,31,1031,Saints,#9f8958,51211,4194,15825,20513,0.204455711,0.771462,-11631,11631,-0.567006289,0.567006289
Alabama,AL,Colbert County,1,33,1033,Saints,#9f8958,54354,7296,16718,24626,0.296272233,0.678875985,-9422,9422,-0.382603752,0.382603752
Alabama,AL,Conecuh County,1,35,1035,Saints,#9f8958,12672,3069,3413,6543,0.469050894,0.521626165,-344,344,-0.052575271,0.052575271
Alabama,AL,Coosa County,1,37,1037,Saints,#9f8958,10724,1780,3376,5223,0.340800306,0.646371817,-1596,1596,-0.305571511,0.305571511
Alabama,AL,Covington County,1,39,1039,Saints,#9f8958,37835,2379,13222,15818,0.15039828,0.835883171,-10843,10843,-0.685484891,0.685484891
Alabama,AL,Crenshaw County,1,41,1041,Saints,#9f8958,13963,1663,4511,6252,0.265994882,0.721529111,-2848,2848,-0.455534229,0.455534229
Alabama,AL,Cullman County,1,43,1043,Saints,#9f8958,82005,3730,32734,37278,0.100059016,0.878105049,-29004,29004,-0.778046033,0.778046033
Alabama,AL,Dale County,1,45,1045,Saints,#9f8958,49565,4408,13798,18617,0.236772842,0.741150561,-9390,9390,-0.504377719,0.504377719
Alabama,AL,Dallas County,1,47,1047,Saints,#9f8958,41131,12826,5784,18730,0.684783769,0.308809397,7042,-7042,0.375974373,-0.375974373
Alabama,AL,DeKalb County,1,49,1049,Falcons,#a71930,71130,3682,21779,26086,0.141148509,0.834892279,-18097,18097,-0.693743771,0.693743771
Alabama,AL,Elmore County,1,51,1051,Saints,#9f8958,81468,8436,27619,36905,0.228586912,0.748380978,-19183,19183,-0.519794066,0.519794066
Alabama,AL,Escambia County,1,53,1053,Saints,#9f8958,37789,4698,10282,15213,0.308814829,0.675869322,-5584,5584,-0.367054493,0.367054493
Alabama,AL,Etowah County,1,55,1055,Falcons,#a71930,103057,10350,32132,43474,0.238073331,0.739108433,-21782,21782,-0.501035101,0.501035101
Alabama,AL,Fayette County,1,57,1057,Saints,#9f8958,16759,1358,6705,8196,0.165690581,0.818081991,-5347,5347,-0.65239141,0.65239141
Alabama,AL,Franklin County,1,59,1059,Saints,#9f8958,31696,2197,9466,11955,0.18377248,0.791802593,-7269,7269,-0.608030113,0.608030113
Alabama,AL,Geneva County,1,61,1061,Saints,#9f8958,26777,1522,9967,11659,0.130542928,0.854876061,-8445,8445,-0.724333133,0.724333133
Alabama,AL,Greene County,1,63,1063,Saints,#9f8958,8479,4006,838,4862,0.823940765,0.172357055,3168,-3168,0.65158371,-0.65158371
Alabama,AL,Hale County,1,65,1065,Saints,#9f8958,15068,4772,3172,8010,0.595755306,0.396004994,1600,-1600,0.199750312,-0.199750312
Alabama,AL,Henry County,1,67,1067,Falcons,#a71930,17221,2286,5623,8017,0.285144069,0.701384558,-3337,3337,-0.416240489,0.416240489
Alabama,AL,Houston County,1,69,1069,Saints,#9f8958,104173,10547,30567,42030,0.250939805,0.727266238,-20020,20020,-0.476326433,0.476326433
Alabama,AL,Jackson County,1,71,1071,Falcons,#a71930,52419,3663,16643,20785,0.17623286,0.800721674,-12980,12980,-0.624488814,0.624488814
Alabama,AL,Jefferson County,1,73,1073,Saints,#9f8958,660367,151581,130614,290111,0.522493115,0.450220778,20967,-20967,0.072272337,-0.072272337
Alabama,AL,Lamar County,1,75,1075,Saints,#9f8958,13886,1035,5819,6931,0.149329101,0.839561391,-4784,4784,-0.69023229,0.69023229
Alabama,AL,Lauderdale County,1,77,1077,Saints,#9f8958,92596,9877,27735,38813,0.254476593,0.714580166,-17858,17858,-0.460103574,0.460103574
Alabama,AL,Lawrence County,1,79,1079,Cowboys,#002244,33115,3611,10732,14623,0.246939752,0.73391233,-7121,7121,-0.486972577,0.486972577
Alabama,AL,Lee County,1,81,1081,Falcons,#a71930,156993,20987,34321,57668,0.363928002,0.595148089,-13334,13334,-0.231220087,0.231220087
Alabama,AL,Limestone County,1,83,1083,Saints,#9f8958,91663,9340,28824,39400,0.237055838,0.731573604,-19484,19484,-0.494517766,0.494517766
Alabama,AL,Lowndes County,1,85,1085,Saints,#9f8958,10458,4882,1751,6676,0.731276213,0.262282804,3131,-3131,0.468993409,-0.468993409
Alabama,AL,Macon County,1,87,1087,Saints,#9f8958,19105,7237,1394,8748,0.827274806,0.159350709,5843,-5843,0.667924097,-0.667924097
Alabama,AL,Madison County,1,89,1089,Saints,#9f8958,353089,62435,89199,159473,0.39150828,0.559336063,-26764,26764,-0.167827783,0.167827783
Alabama,AL,Marengo County,1,91,1091,Saints,#9f8958,20028,5607,5224,10948,0.512148338,0.477164779,383,-383,0.034983559,-0.034983559
Alabama,AL,Marion County,1,93,1093,Saints,#9f8958,30168,1432,11273,12912,0.110904585,0.873063817,-9841,9841,-0.762159232,0.762159232
Alabama,AL,Marshall County,1,95,1095,Falcons,#a71930,94725,4913,29217,34965,0.140511941,0.835607036,-24304,24304,-0.695095095,0.695095095
Alabama,AL,Mobile County,1,97,1097,Saints,#9f8958,415395,68429,91087,163387,0.41881545,0.557492334,-22658,22658,-0.138676884,0.138676884
Alabama,AL,Monroe County,1,99,1099,Saints,#9f8958,21673,4310,5771,10185,0.42317133,0.566617575,-1461,1461,-0.143446244,0.143446244
Alabama,AL,Montgomery County,1,101,1101,Saints,#9f8958,226519,58669,33928,94572,0.620363321,0.358753119,24741,-24741,0.261610202,-0.261610202
Alabama,AL,Morgan County,1,103,1103,Saints,#9f8958,119565,11216,37392,49991,0.224360385,0.747974635,-26176,26176,-0.523614251,0.523614251
Alabama,AL,Perry County,1,105,1105,Saints,#9f8958,9652,3823,1403,5255,0.727497621,0.266983825,2420,-2420,0.460513796,-0.460513796
Alabama,AL,Pickens County,1,107,1107,Saints,#9f8958,20864,3972,5454,9494,0.418369497,0.574468085,-1482,1482,-0.156098589,0.156098589
Alabama,AL,Pike County,1,109,1109,Saints,#9f8958,33046,5039,7681,13025,0.386871401,0.589712092,-2642,2642,-0.202840691,0.202840691
Alabama,AL,Randolph County,1,111,1111,Falcons,#a71930,22696,2290,7697,10130,0.226061204,0.75982231,-5407,5407,-0.533761106,0.533761106
Alabama,AL,Russell County,1,113,1113,Falcons,#a71930,59660,9577,9210,19136,0.500470318,0.481291806,367,-367,0.019178512,-0.019178512
Alabama,AL,St. Clair County,1,115,1115,Saints,#9f8958,87074,5550,31579,37937,0.146295174,0.832406358,-26029,26029,-0.686111184,0.686111184
Alabama,AL,Shelby County,1,117,1117,Saints,#9f8958,208713,22927,72846,99208,0.231100314,0.734275462,-49919,49919,-0.503175147,0.503175147
Alabama,AL,Sumter County,1,119,1119,Saints,#9f8958,13103,4739,1581,6391,0.741511501,0.247379127,3158,-3158,0.494132374,-0.494132374
Alabama,AL,Talladega County,1,121,1121,Saints,#9f8958,80862,12108,20596,33218,0.364501174,0.620025287,-8488,8488,-0.255524113,0.255524113
Alabama,AL,Tallapoosa County,1,123,1123,Saints,#9f8958,40844,5271,12967,18504,0.284857328,0.700767402,-7696,7696,-0.415910073,0.415910073
Alabama,AL,Tuscaloosa County,1,125,1125,Saints,#9f8958,203976,31746,47701,81708,0.388529887,0.583798404,-15955,15955,-0.195268517,0.195268517
Alabama,AL,Walker County,1,127,1127,Saints,#9f8958,65294,4486,24208,29243,0.153404233,0.827822043,-19722,19722,-0.674417809,0.674417809
Alabama,AL,Washington County,1,129,1129,Saints,#9f8958,16804,2366,6031,8492,0.278615167,0.710197833,-3665,3665,-0.431582666,0.431582666
Alabama,AL,Wilcox County,1,131,1131,Saints,#9f8958,11059,4329,1737,6095,0.710254307,0.284987695,2592,-2592,0.425266612,-0.425266612
Alabama,AL,Winston County,1,133,1133,Saints,#9f8958,23877,871,9225,10255,0.084934178,0.89956119,-8354,8354,-0.814627011,0.814627011
Alaska,AK,Aleutians East Borough,2,13,2013,Seahawks,#69be28,738432,93007,130415,246588,0.377175694,0.528878129,-37408,37408,-0.151702435,0.151702435
Alaska,AK,Aleutians West Census Area,2,16,2016,Seahawks,#69be28,738432,93007,130415,246588,0.377175694,0.528878129,-37408,37408,-0.151702435,0.151702435
Alaska,AK,Anchorage Municipality,2,20,2020,Seahawks,#69be28,738432,93007,130415,246588,0.377175694,0.528878129,-37408,37408,-0.151702435,0.151702435
Alaska,AK,Bethel Census Area,2,50,2050,Seahawks,#69be28,738432,93007,130415,246588,0.377175694,0.528878129,-37408,37408,-0.151702435,0.151702435
Alaska,AK,Bristol Bay Borough,2,60,2060,Seahawks,#69be28,738432,93007,130415,246588,0.377175694,0.528878129,-37408,37408,-0.151702435,0.151702435
Alaska,AK,Denali Borough,2,68,2068,Seahawks,#69be28,738432,93007,130415,246588,0.377175694,0.528878129,-37408,37408,-0.151702435,0.151702435
Alaska,AK,Dillingham Census Area,2,70,2070,Seahawks,#69be28,738432,93007,130415,246588,0.377175694,0.528878129,-37408,37408,-0.151702435,0.151702435
Alaska,AK,Fairbanks North Star Borough,2,90,2090,Seahawks,#69be28,738432,93007,130415,246588,0.377175694,0.528878129,-37408,37408,-0.151702435,0.151702435
Alaska,AK,Haines Borough,2,100,2100,Seahawks,#69be28,738432,93007,130415,246588,0.377175694,0.528878129,-37408,37408,-0.151702435,0.151702435
Alaska,AK,Hoonah-Angoon Census Area,2,105,2105,Seahawks,#69be28,738432,93007,130415,246588,0.377175694,0.528878129,-37408,37408,-0.151702435,0.151702435
Alaska,AK,Juneau City and Borough,2,110,2110,Seahawks,#69be28,738432,93007,130415,246588,0.377175694,0.528878129,-37408,37408,-0.151702435,0.151702435
Alaska,AK,Kenai Peninsula Borough,2,122,2122,Seahawks,#69be28,738432,93007,130415,246588,0.377175694,0.528878129,-37408,37408,-0.151702435,0.151702435
Alaska,AK,Ketchikan Gateway Borough,2,130,2130,Seahawks,#69be28,738432,93007,130415,246588,0.377175694,0.528878129,-37408,37408,-0.151702435,0.151702435
Alaska,AK,Kodiak Island Borough,2,150,2150,Seahawks,#69be28,738432,93007,130415,246588,0.377175694,0.528878129,-37408,37408,-0.151702435,0.151702435
Alaska,AK,Wade Hampton Census Area,2,158,2158,Seahawks,#69be28,738432,93007,130415,246588,0.377175694,0.528878129,-37408,37408,-0.151702435,0.151702435
Alaska,AK,Lake and Peninsula Borough,2,164,2164,Seahawks,#69be28,738432,93007,130415,246588,0.377175694,0.528878129,-37408,37408,-0.151702435,0.151702435
Alaska,AK,Matanuska-Susitna Borough,2,170,2170,Seahawks,#69be28,738432,93007,130415,246588,0.377175694,0.528878129,-37408,37408,-0.151702435,0.151702435
Alaska,AK,Nome Census Area,2,180,2180,Seahawks,#69be28,738432,93007,130415,246588,0.377175694,0.528878129,-37408,37408,-0.151702435,0.151702435
Alaska,AK,North Slope Borough,2,185,2185,Seahawks,#69be28,738432,93007,130415,246588,0.377175694,0.528878129,-37408,37408,-0.151702435,0.151702435
Alaska,AK,Northwest Arctic Borough,2,188,2188,Seahawks,#69be28,738432,93007,130415,246588,0.377175694,0.528878129,-37408,37408,-0.151702435,0.151702435
Alaska,AK,Petersburg Census Area,2,195,2195,Seahawks,#69be28,738432,93007,130415,246588,0.377175694,0.528878129,-37408,37408,-0.151702435,0.151702435
Alaska,AK,Prince of Wales-Hyder Census Area,2,198,2198,Seahawks,#69be28,738432,93007,130415,246588,0.377175694,0.528878129,-37408,37408,-0.151702435,0.151702435
Alaska,AK,#N/A,2,201,2201,Seahawks,#69be28,#N/A,#N/A,#N/A,#N/A,#N/A,#N/A,#N/A,#N/A,#N/A,#N/A
Alaska,AK,Sitka City and Borough,2,220,2220,Seahawks,#69be28,738432,93007,130415,246588,0.377175694,0.528878129,-37408,37408,-0.151702435,0.151702435
Alaska,AK,Skagway Municipality,2,230,2230,Seahawks,#69be28,738432,93007,130415,246588,0.377175694,0.528878129,-37408,37408,-0.151702435,0.151702435
Alaska,AK,#N/A,2,232,2232,Seahawks,#69be28,#N/A,#N/A,#N/A,#N/A,#N/A,#N/A,#N/A,#N/A,#N/A,#N/A
Alaska,AK,Southeast Fairbanks Census Area,2,240,2240,Seahawks,#69be28,738432,93007,130415,246588,0.377175694,0.528878129,-37408,37408,-0.151702435,0.151702435
Alaska,AK,Valdez-Cordova Census Area,2,261,2261,Seahawks,#69be28,738432,93007,130415,246588,0.377175694,0.528878129,-37408,37408,-0.151702435,0.151702435
Alaska,AK,#N/A,2,270,2270,Seahawks,#69be28,#N/A,#N/A,#N/A,#N/A,#N/A,#N/A,#N/A,#N/A,#N/A,#N/A
Alaska,AK,Wrangell City and Borough,2,275,2275,Seahawks,#69be28,738432,93007,130415,246588,0.377175694,0.528878129,-37408,37408,-0.151702435,0.151702435
Alaska,AK,#N/A,2,280,2280,Seahawks,#69be28,#N/A,#N/A,#N/A,#N/A,#N/A,#N/A,#N/A,#N/A,#N/A,#N/A
Alaska,AK,Yakutat City and Borough,2,282,2282,Seahawks,#69be28,738432,93007,130415,246588,0.377175694,0.528878129,-37408,37408,-0.151702435,0.151702435
Alaska,AK,Yukon-Koyukuk Census Area,2,290,2290,Seahawks,#69be28,738432,93007,130415,246588,0.377175694,0.528878129,-37408,37408,-0.151702435,0.151702435
Arizona,AZ,Apache County,4,1,4001,Cardinals,#97233f,71474,12196,5315,18659,0.653625596,0.284849134,6881,-6881,0.368776462,-0.368776462
Arizona,AZ,Cochise County,4,3,4003,Cardinals,#97233f,126427,15291,25036,43147,0.354393121,0.580248916,-9745,9745,-0.225855795,0.225855795
Arizona,AZ,Coconino County,4,5,4005,Cardinals,#97233f,139097,25308,16573,44929,0.563288744,0.368870885,8735,-8735,0.194417859,-0.194417859
Arizona,AZ,Gila County,4,7,4007,Cardinals,#97233f,53159,6746,13672,21398,0.315263109,0.638938219,-6926,6926,-0.32367511,0.32367511
Arizona,AZ,Graham County,4,9,4009,Cardinals,#97233f,37666,3301,8025,11939,0.276488818,0.672166848,-4724,4724,-0.39567803,0.39567803
Arizona,AZ,Greenlee County,4,11,4011,Cardinals,#97233f,9529,1092,1892,3243,0.336725254,0.583410422,-800,800,-0.246685168,0.246685168
Arizona,AZ,La Paz County,4,12,4012,Cardinals,#97233f,20152,1318,3381,4931,0.267288582,0.685662137,-2063,2063,-0.418373555,0.418373555
Arizona,AZ,Maricopa County,4,13,4013,Cardinals,#97233f,4167947,549040,590465,1201934,0.456797129,0.491262415,-41425,41425,-0.034465287,0.034465287
Arizona,AZ,Mohave County,4,15,4015,Cardinals,#97233f,204737,16485,54656,74189,0.222202752,0.73671299,-38171,38171,-0.514510237,0.514510237
Arizona,AZ,Navajo County,4,17,4017,Cardinals,#97233f,108277,15362,18165,35409,0.433844503,0.513005168,-2803,2803,-0.079160665,0.079160665
Arizona,AZ,Pima County,4,19,4019,Cardinals,#97233f,1010025,195649,147019,360762,0.542321531,0.40752352,48630,-48630,0.134798011,-0.134798011
Arizona,AZ,Pinal County,4,21,4021,Cardinals,#97233f,406584,35737,53857,93805,0.380971164,0.574137839,-18120,18120,-0.193166676,0.193166676
Arizona,AZ,Santa Cruz County,4,23,4023,Cardinals,#97233f,46461,10684,3650,14926,0.715797936,0.244539729,7034,-7034,0.471258207,-0.471258207
Arizona,AZ,Yavapai County,4,25,4025,Cardinals,#97233f,222255,29705,58862,92780,0.320165984,0.634425523,-29157,29157,-0.314259539,0.314259539
Arizona,AZ,Yuma County,4,27,4027,Cardinals,#97233f,204275,18336,20586,40759,0.449863834,0.505066366,-2250,2250,-0.055202532,0.055202532
Arkansas,AR,Arkansas County,5,1,5001,Cowboys,#002244,18433,1939,3825,6167,0.314415437,0.620236744,-1886,1886,-0.305821307,0.305821307
Arkansas,AR,Ashley County,5,3,5003,Saints,#9f8958,20838,2408,5338,8027,0.299987542,0.665005606,-2930,2930,-0.365018064,0.365018064
Arkansas,AR,Baxter County,5,5,5005,Cowboys,#002244,41053,4163,14655,19572,0.212701819,0.748773758,-10492,10492,-0.53607194,0.53607194
Arkansas,AR,Benton County,5,7,5007,Cowboys,#002244,249672,27894,60751,94262,0.295919883,0.644490887,-32857,32857,-0.348571004,0.348571004
Arkansas,AR,Boone County,5,9,5009,Cowboys,#002244,37222,2925,12225,15912,0.183823529,0.768288084,-9300,9300,-0.584464555,0.584464555
Arkansas,AR,Bradley County,5,11,5011,Cowboys,#002244,11094,1317,2163,3617,0.364113907,0.5980094,-846,846,-0.233895494,0.233895494
Arkansas,AR,Calhoun County,5,13,5013,Cowboys,#002244,5229,636,1554,2250,0.282666667,0.690666667,-918,918,-0.408,0.408
Arkansas,AR,Carroll County,5,15,5015,Cowboys,#002244,27704,3334,6773,10656,0.312875375,0.635604354,-3439,3439,-0.322728979,0.322728979
Arkansas,AR,Chicot County,5,17,5017,Saints,#9f8958,11027,2350,1716,4149,0.566401543,0.413593637,634,-634,0.152807906,-0.152807906
Arkansas,AR,Clark County,5,19,5019,Cowboys,#002244,22633,3606,4398,8365,0.431081889,0.525762104,-792,792,-0.094680215,0.094680215
Arkansas,AR,Clay County,5,21,5021,Cowboys,#002244,15109,1999,3779,5978,0.334392774,0.632151221,-1780,1780,-0.297758448,0.297758448
Arkansas,AR,Cleburne County,5,23,5023,Cowboys,#002244,25467,2101,9454,11968,0.175551471,0.78993984,-7353,7353,-0.614388369,0.614388369
Arkansas,AR,Cleveland County,5,25,5025,Cowboys,#002244,8311,723,2460,3299,0.21915732,0.745680509,-1737,1737,-0.526523189,0.526523189
Arkansas,AR,Columbia County,5,27,5027,Saints,#9f8958,24114,3140,5456,8837,0.355324205,0.617404096,-2316,2316,-0.262079891,0.262079891
Arkansas,AR,Conway County,5,29,5029,Cowboys,#002244,21019,2655,4844,7837,0.338777593,0.618093658,-2189,2189,-0.279316065,0.279316065
Arkansas,AR,Craighead County,5,31,5031,Cowboys,#002244,104354,10474,22798,34968,0.299531,0.651967513,-12324,12324,-0.352436513,0.352436513
Arkansas,AR,Crawford County,5,33,5033,Cowboys,#002244,61703,4476,16655,22155,0.202031144,0.751749041,-12179,12179,-0.549717897,0.549717897
Arkansas,AR,Crittenden County,5,35,5035,Cowboys,#002244,48963,8368,6953,15798,0.529687302,0.440119002,1415,-1415,0.0895683,-0.0895683
Arkansas,AR,Cross County,5,37,5037,Cowboys,#002244,17284,1995,4577,6831,0.292050944,0.67003367,-2582,2582,-0.377982726,0.377982726
Arkansas,AR,Dallas County,5,39,5039,Cowboys,#002244,7604,1165,1507,2741,0.425027362,0.549799343,-342,342,-0.124771981,0.124771981
Arkansas,AR,Desha County,5,41,5041,Cowboys,#002244,11965,2227,1915,4226,0.526975864,0.453147184,312,-312,0.07382868,-0.07382868
Arkansas,AR,Drew County,5,43,5043,Saints,#9f8958,18778,2364,3967,6552,0.360805861,0.60546398,-1603,1603,-0.24465812,0.24465812
Arkansas,AR,Faulkner County,5,45,5045,Cowboys,#002244,121552,14525,29170,46364,0.313281857,0.629151928,-14645,14645,-0.315870072,0.315870072
Arkansas,AR,Franklin County,5,47,5047,Cowboys,#002244,17702,1376,5034,6698,0.205434458,0.751567632,-3658,3658,-0.546133174,0.546133174
Arkansas,AR,Fulton County,5,49,5049,Cowboys,#002244,12204,1067,3470,4744,0.224915683,0.731450253,-2403,2403,-0.50653457,0.50653457
Arkansas,AR,Garland County,5,51,5051,Cowboys,#002244,97177,12283,26053,40337,0.304509507,0.645883432,-13770,13770,-0.341373925,0.341373925
Arkansas,AR,Grant County,5,53,5053,Cowboys,#002244,18102,1407,5160,6855,0.205251641,0.75273523,-3753,3753,-0.547483589,0.547483589
Arkansas,AR,Greene County,5,55,5055,Cowboys,#002244,44196,3056,10698,14422,0.211898488,0.741783386,-7642,7642,-0.529884898,0.529884898
Arkansas,AR,Hempstead County,5,57,5057,Cowboys,#002244,22084,2371,4391,6984,0.339490263,0.628722795,-2020,2020,-0.289232532,0.289232532
Arkansas,AR,Hot Spring County,5,59,5059,Cowboys,#002244,33426,3137,8153,11815,0.265509945,0.690055015,-5016,5016,-0.42454507,0.42454507
Arkansas,AR,Howard County,5,61,5061,Cowboys,#002244,13300,1350,3155,4634,0.291324989,0.68083729,-1805,1805,-0.3895123,0.3895123
Arkansas,AR,Independence County,5,63,5063,Cowboys,#002244,37052,2878,9925,13443,0.214089117,0.738302462,-7047,7047,-0.524213345,0.524213345
Arkansas,AR,Izard County,5,65,5065,Cowboys,#002244,13445,1111,4042,5396,0.205893254,0.749073388,-2931,2931,-0.543180133,0.543180133
Arkansas,AR,Jackson County,5,67,5067,Cowboys,#002244,17338,1583,3262,5093,0.310818771,0.640486943,-1679,1679,-0.329668172,0.329668172
Arkansas,AR,Jefferson County,5,69,5069,Cowboys,#002244,71565,15721,9231,25683,0.612116965,0.359420628,6490,-6490,0.252696336,-0.252696336
Arkansas,AR,Johnson County,5,71,5071,Cowboys,#002244,26141,2421,6072,8997,0.269089697,0.674891631,-3651,3651,-0.405801934,0.405801934
Arkansas,AR,Lafayette County,5,73,5073,Cowboys,#002244,6996,1028,1750,2835,0.362610229,0.617283951,-722,722,-0.254673721,0.254673721
Arkansas,AR,Lawrence County,5,75,5075,Cowboys,#002244,16779,1263,4064,5629,0.224373779,0.721975484,-2801,2801,-0.497601705,0.497601705
Arkansas,AR,Lee County,5,77,5077,Cowboys,#002244,9650,1735,1229,3004,0.577563249,0.409121172,506,-506,0.168442077,-0.168442077
Arkansas,AR,Lincoln County,5,79,5079,Cowboys,#002244,13820,1252,2455,3814,0.328264289,0.643681175,-1203,1203,-0.315416885,0.315416885
Arkansas,AR,Little River County,5,81,5081,Cowboys,#002244,12472,1397,3604,5192,0.269067797,0.694144838,-2207,2207,-0.425077042,0.425077042
Arkansas,AR,Logan County,5,83,5083,Cowboys,#002244,21714,1712,5737,7839,0.218395203,0.731853553,-4025,4025,-0.513458349,0.513458349
Arkansas,AR,Lonoke County,5,85,5085,Cowboys,#002244,71645,5638,19902,26766,0.210640365,0.743555257,-14264,14264,-0.532914892,0.532914892
Arkansas,AR,Madison County,5,87,5087,Cowboys,#002244,15767,1587,4917,6782,0.234001769,0.725007372,-3330,3330,-0.491005603,0.491005603
Arkansas,AR,Marion County,5,89,5089,Cowboys,#002244,16185,1377,5077,6718,0.204971718,0.755730872,-3700,3700,-0.550759155,0.550759155
Arkansas,AR,Miller County,5,91,5091,Cowboys,#002244,43908,4273,11293,16015,0.266812363,0.705151421,-7020,7020,-0.438339057,0.438339057
Arkansas,AR,Mississippi County,5,93,5093,Cowboys,#002244,43738,5621,6988,12995,0.432550981,0.537745287,-1367,1367,-0.105194306,0.105194306
Arkansas,AR,Monroe County,5,95,5095,Cowboys,#002244,7399,1298,1400,2766,0.469269704,0.506146059,-102,102,-0.036876356,0.036876356
Arkansas,AR,Montgomery County,5,97,5097,Cowboys,#002244,8970,735,2573,3445,0.213352685,0.746879536,-1838,1838,-0.533526851,0.533526851
Arkansas,AR,Nevada County,5,99,5099,Cowboys,#002244,8558,1156,2001,3233,0.357562635,0.618929787,-845,845,-0.261367151,0.261367151
Arkansas,AR,Newton County,5,101,5101,Cowboys,#002244,7913,699,2875,3731,0.187349236,0.770570893,-2176,2176,-0.583221656,0.583221656
Arkansas,AR,Ouachita County,5,103,5103,Cowboys,#002244,24358,4320,5347,9881,0.437202712,0.541139561,-1027,1027,-0.103936848,0.103936848
Arkansas,AR,Perry County,5,105,5105,Cowboys,#002244,10189,1035,2979,4213,0.24566817,0.70709708,-1944,1944,-0.461428911,0.461428911
Arkansas,AR,Phillips County,5,107,5107,Cowboys,#002244,19513,4292,2443,6894,0.622570351,0.354366115,1849,-1849,0.268204236,-0.268204236
Arkansas,AR,Pike County,5,109,5109,Cowboys,#002244,10824,684,3150,3956,0.172901921,0.796258847,-2466,2466,-0.623356926,0.623356926
Arkansas,AR,Poinsett County,5,111,5111,Cowboys,#002244,24040,1878,3149,5283,0.355479841,0.596062843,-1271,1271,-0.240583002,0.240583002
Arkansas,AR,Polk County,5,113,5113,Cowboys,#002244,20216,1210,6606,8121,0.148996429,0.81344662,-5396,5396,-0.664450191,0.664450191
Arkansas,AR,Pope County,5,115,5115,Cowboys,#002244,63390,4818,15694,21545,0.223624971,0.72842887,-10876,10876,-0.504803899,0.504803899
Arkansas,AR,Prairie County,5,117,5117,Cowboys,#002244,8291,812,2503,3404,0.238542891,0.735311398,-1691,1691,-0.496768508,0.496768508
Arkansas,AR,Pulaski County,5,119,5119,Cowboys,#002244,392664,89377,61182,157728,0.566652719,0.387895618,28195,-28195,0.178757101,-0.178757101
Arkansas,AR,Randolph County,5,121,5121,Cowboys,#002244,17469,1425,4508,6313,0.225724695,0.714082053,-3083,3083,-0.488357358,0.488357358
Arkansas,AR,St. Francis County,5,123,5123,Cowboys,#002244,26589,4031,3195,7412,0.543847814,0.431057744,836,-836,0.11279007,-0.11279007
Arkansas,AR,Saline County,5,125,5125,Cowboys,#002244,117460,13247,35852,51971,0.254892151,0.68984626,-22605,22605,-0.434954109,0.434954109
Arkansas,AR,Scott County,5,127,5127,Cowboys,#002244,10513,507,2378,3017,0.16804773,0.788200199,-1871,1871,-0.620152469,0.620152469
Arkansas,AR,Searcy County,5,129,5129,Cowboys,#002244,7869,601,2955,3698,0.162520281,0.799080584,-2354,2354,-0.636560303,0.636560303
Arkansas,AR,Sebastian County,5,131,5131,Cowboys,#002244,127780,12184,28769,43557,0.279725417,0.660490851,-16585,16585,-0.380765434,0.380765434
Arkansas,AR,Sevier County,5,133,5133,Cowboys,#002244,17290,1075,3281,4517,0.237989816,0.726367058,-2206,2206,-0.488377242,0.488377242
Arkansas,AR,Sharp County,5,135,5135,Cowboys,#002244,16912,1472,5405,7190,0.20472879,0.751738526,-3933,3933,-0.547009736,0.547009736
Arkansas,AR,Stone County,5,137,5137,Cowboys,#002244,12456,1189,4081,5527,0.215125746,0.738375249,-2892,2892,-0.523249502,0.523249502
Arkansas,AR,Union County,5,139,5139,Saints,#9f8958,40144,5667,10201,16338,0.346860081,0.624372628,-4534,4534,-0.277512547,0.277512547
Arkansas,AR,Van Buren County,5,141,5141,Cowboys,#002244,16771,1547,5382,7111,0.217550274,0.756855576,-3835,3835,-0.539305302,0.539305302
Arkansas,AR,Washington County,5,143,5143,Cowboys,#002244,225477,32296,40418,78153,0.413240695,0.517165048,-8122,8122,-0.103924354,0.103924354
Arkansas,AR,White County,5,145,5145,Cowboys,#002244,79161,5157,21038,27451,0.187862009,0.766383738,-15881,15881,-0.57852173,0.57852173
Arkansas,AR,Woodruff County,5,147,5147,Cowboys,#002244,6741,1117,1344,2550,0.438039216,0.527058824,-227,227,-0.089019608,0.089019608
Arkansas,AR,Yell County,5,149,5149,Cowboys,#002244,21713,1472,4600,6389,0.230395993,0.719987478,-3128,3128,-0.489591485,0.489591485
California,CA,Alameda County,6,1,6001,49ers,#aa0000,1638215,486351,91189,613195,0.793142475,0.148711258,395162,-395162,0.644431217,-0.644431217
California,CA,Alpine County,6,3,6003,49ers,#aa0000,1110,318,211,575,0.553043478,0.366956522,107,-107,0.186086957,-0.186086957
California,CA,Amador County,6,5,6005,49ers,#aa0000,37001,5904,10239,17186,0.343535436,0.595775631,-4335,4335,-0.252240196,0.252240196
California,CA,Butte County,6,7,6007,49ers,#aa0000,225411,38676,42193,87847,0.440265462,0.480300978,-3517,3517,-0.040035516,0.040035516
California,CA,Calaveras County,6,9,6009,49ers,#aa0000,44828,7738,13072,22334,0.34646727,0.585295961,-5334,5334,-0.238828692,0.238828692
California,CA,Colusa County,6,11,6011,49ers,#aa0000,21482,2518,3464,6346,0.396785377,0.545855657,-946,946,-0.14907028,0.14907028
California,CA,Contra Costa County,6,13,6013,49ers,#aa0000,1126745,286658,105819,415972,0.689128114,0.254389719,180839,-180839,0.434738396,-0.434738396
California,CA,Del Norte County,6,15,6015,49ers,#aa0000,27254,3485,5134,9361,0.372289285,0.548445679,-1649,1649,-0.176156394,0.176156394
California,CA,El Dorado County,6,17,6017,49ers,#aa0000,184452,35243,47633,89228,0.394976913,0.533834671,-12390,12390,-0.138857758,0.138857758
California,CA,Fresno County,6,19,6019,49ers,#aa0000,974861,123660,113949,250264,0.494118211,0.455315187,9711,-9711,0.038803024,-0.038803024
California,CA,Glenn County,6,21,6021,49ers,#aa0000,28017,3065,5788,9379,0.326793901,0.617123361,-2723,2723,-0.290329459,0.290329459
California,CA,Humboldt County,6,23,6023,49ers,#aa0000,135727,19596,10883,33636,0.582590082,0.323552147,8713,-8713,0.259037936,-0.259037936
California,CA,Imperial County,6,25,6025,Chargers,#ffb612,180191,23887,9318,34807,0.686270003,0.267704772,14569,-14569,0.418565231,-0.418565231
California,CA,Inyo County,6,27,6027,49ers,#aa0000,18260,3155,4248,7996,0.394572286,0.531265633,-1093,1093,-0.136693347,0.136693347
California,CA,Kern County,6,29,6029,49ers,#aa0000,882176,86481,119164,217725,0.397202894,0.547314273,-32683,32683,-0.150111379,0.150111379
California,CA,Kings County,6,31,6031,49ers,#aa0000,150965,12902,17446,32250,0.400062016,0.54096124,-4544,4544,-0.140899225,0.140899225
California,CA,Lake County,6,33,6033,49ers,#aa0000,64591,6240,5752,13045,0.478344193,0.440935224,488,-488,0.037408969,-0.037408969
California,CA,Lassen County,6,35,6035,49ers,#aa0000,31345,2224,7574,10422,0.213394742,0.726731913,-5350,5350,-0.513337171,0.513337171
California,CA,Los Angeles County,6,37,6037,Raiders,#000000,10170292,1893770,620285,2652072,0.714071865,0.233886938,1273485,-1273485,0.480184927,-0.480184927
California,CA,Madera County,6,39,6039,49ers,#aa0000,154998,13283,19221,34263,0.38767767,0.560984152,-5938,5938,-0.173306482,0.173306482
California,CA,Marin County,6,41,6041,49ers,#aa0000,261221,69518,14214,88115,0.788946263,0.161311922,55304,-55304,0.627634341,-0.627634341
California,CA,Mariposa County,6,43,6043,49ers,#aa0000,17531,3122,5185,8877,0.351695393,0.584093725,-2063,2063,-0.232398333,0.232398333
California,CA,Mendocino County,6,45,6045,49ers,#aa0000,87649,6905,3571,11435,0.603847836,0.312286839,3334,-3334,0.291560997,-0.291560997
California,CA,Merced County,6,47,6047,49ers,#aa0000,268455,21856,18486,42523,0.513980669,0.434729441,3370,-3370,0.079251229,-0.079251229
California,CA,Modoc County,6,49,6049,Raiders,#000000,8965,798,2413,3359,0.237570706,0.718368562,-1615,1615,-0.480797857,0.480797857
California,CA,Mono County,6,51,6051,49ers,#aa0000,13909,2696,2080,5154,0.523088863,0.403570043,616,-616,0.11951882,-0.11951882
California,CA,Monterey County,6,53,6053,49ers,#aa0000,433898,64733,26378,96676,0.669587074,0.272849518,38355,-38355,0.396737556,-0.396737556
California,CA,Napa County,6,55,6055,49ers,#aa0000,142456,26161,11946,40393,0.647661724,0.295744312,14215,-14215,0.351917411,-0.351917411
California,CA,Nevada County,6,57,6057,49ers,#aa0000,98877,16199,14686,33258,0.48707078,0.441577966,1513,-1513,0.045492814,-0.045492814
California,CA,Orange County,6,59,6059,Chargers,#ffb612,3169776,556544,472669,1092116,0.509601544,0.432801094,83875,-83875,0.07680045,-0.07680045
California,CA,Placer County,6,61,6061,49ers,#aa0000,375391,61969,78977,150532,0.411666622,0.524652566,-17008,17008,-0.112985943,0.112985943
California,CA,Plumas County,6,63,6063,49ers,#aa0000,18409,3224,5079,8830,0.365118913,0.575198188,-1855,1855,-0.210079275,0.210079275
California,CA,Riverside County,6,65,6065,Chargers,#ffb612,2361026,300686,279072,609869,0.49303375,0.457593352,21614,-21614,0.035440398,-0.035440398
California,CA,Sacramento County,6,67,6067,49ers,#aa0000,1501335,273768,163024,467526,0.585567434,0.348695046,110744,-110744,0.236872388,-0.236872388
California,CA,San Benito County,6,69,6069,49ers,#aa0000,58792,8309,5530,14688,0.565699891,0.376497821,2779,-2779,0.18920207,-0.18920207
California,CA,San Bernardino County,6,71,6071,Raiders,#000000,2128133,304407,249103,585169,0.520203565,0.425694116,55304,-55304,0.094509449,-0.094509449
California,CA,San Diego County,6,73,6073,Chargers,#ffb612,3299521,567243,386807,1011651,0.560710166,0.382352214,180436,-180436,0.178357952,-0.178357952
California,CA,San Francisco County,6,75,6075,49ers,#aa0000,864816,312443,34493,365295,0.855316936,0.094425054,277950,-277950,0.760891882,-0.760891882
California,CA,San Joaquin County,6,77,6077,49ers,#aa0000,726106,71349,56194,134076,0.532153406,0.419120499,15155,-15155,0.113032907,-0.113032907
California,CA,San Luis Obispo County,6,79,6079,49ers,#aa0000,281401,61021,50755,120296,0.507257099,0.421917603,10266,-10266,0.085339496,-0.085339496
California,CA,San Mateo County,6,81,6081,49ers,#aa0000,765135,192035,47627,251646,0.763115647,0.1892619,144408,-144408,0.573853747,-0.573853747
California,CA,Santa Barbara County,6,83,6083,Raiders,#000000,444769,100120,53740,164224,0.609655105,0.32723597,46380,-46380,0.282419135,-0.282419135
California,CA,Santa Clara County,6,85,6085,49ers,#aa0000,1918044,483472,137452,659148,0.73348019,0.208529799,346020,-346020,0.524950391,-0.524950391
California,CA,Santa Cruz County,6,87,6087,49ers,#aa0000,274146,85185,20158,113509,0.750469126,0.177589442,65027,-65027,0.572879684,-0.572879684
California,CA,Shasta County,6,89,6089,49ers,#aa0000,179533,20471,47587,72554,0.282148469,0.655883893,-27116,27116,-0.373735425,0.373735425
California,CA,Sierra County,6,91,6091,49ers,#aa0000,2967,601,1048,1804,0.333148559,0.580931264,-447,447,-0.247782705,0.247782705
California,CA,Siskiyou County,6,93,6093,49ers,#aa0000,43554,7106,11212,19836,0.358237548,0.565234926,-4106,4106,-0.206997379,0.206997379
California,CA,Solano County,6,95,6095,49ers,#aa0000,436092,94622,48712,152398,0.620887413,0.319636741,45910,-45910,0.301250673,-0.301250673
California,CA,Sonoma County,6,97,6097,49ers,#aa0000,502146,116027,37421,164060,0.707222967,0.22809338,78606,-78606,0.479129587,-0.479129587
California,CA,Stanislaus County,6,99,6099,49ers,#aa0000,538388,73939,72960,156141,0.473539941,0.467269968,979,-979,0.006269974,-0.006269974
California,CA,Sutter County,6,101,6101,49ers,#aa0000,96463,11831,16780,30429,0.38880673,0.551447632,-4949,4949,-0.162640902,0.162640902
California,CA,Tehama County,6,103,6103,49ers,#aa0000,63308,6571,14981,22875,0.287256831,0.654907104,-8410,8410,-0.367650273,0.367650273
California,CA,Trinity County,6,105,6105,49ers,#aa0000,13069,1876,2409,4716,0.397794741,0.510814249,-533,533,-0.113019508,0.113019508
California,CA,Tulare County,6,107,6107,49ers,#aa0000,459863,27975,38062,69408,0.403051521,0.54838059,-10087,10087,-0.145329069,0.145329069
California,CA,Tuolumne County,6,109,6109,49ers,#aa0000,53709,8580,13486,23472,0.365541922,0.574556919,-4906,4906,-0.209014997,0.209014997
California,CA,Ventura County,6,111,6111,Raiders,#000000,850536,170489,118764,307881,0.553749663,0.385746441,51725,-51725,0.168003222,-0.168003222
California,CA,Yolo County,6,113,6113,49ers,#aa0000,213016,34460,13178,50623,0.680718251,0.260316457,21282,-21282,0.420401794,-0.420401794
California,CA,Yuba County,6,115,6115,49ers,#aa0000,74492,7234,12313,21058,0.343527401,0.584718397,-5079,5079,-0.241190996,0.241190996
Colorado,CO,Adams County,8,1,8001,Broncos,#fb4f14,491337,86471,73807,175125,0.493767309,0.421453248,12664,-12664,0.072314061,-0.072314061
Colorado,CO,Alamosa County,8,3,8003,Broncos,#fb4f14,16496,3168,3031,6897,0.459330144,0.439466435,137,-137,0.019863709,-0.019863709
Colorado,CO,Arapahoe County,8,5,8005,Broncos,#fb4f14,631096,148365,109638,281658,0.526755853,0.389259314,38727,-38727,0.137496538,-0.137496538
Colorado,CO,Archuleta County,8,7,8007,Broncos,#fb4f14,12352,2489,4234,7290,0.341426612,0.58079561,-1745,1745,-0.239368999,0.239368999
Colorado,CO,Baca County,8,9,8009,Broncos,#fb4f14,3615,278,1716,2107,0.131941149,0.814428097,-1438,1438,-0.682486948,0.682486948
Colorado,CO,Bent County,8,11,8011,Broncos,#fb4f14,5830,581,1166,1892,0.307082452,0.61627907,-585,585,-0.309196617,0.309196617
Colorado,CO,Boulder County,8,13,8013,Broncos,#fb4f14,319372,124715,38766,176735,0.705661018,0.219345348,85949,-85949,0.48631567,-0.48631567
Colorado,CO,Broomfield County,8,14,8014,Broncos,#fb4f14,65065,19530,14272,37342,0.523003588,0.38219699,5258,-5258,0.140806598,-0.140806598
Colorado,CO,Chaffee County,8,15,8015,Broncos,#fb4f14,18658,4773,5283,10999,0.433948541,0.480316392,-510,510,-0.046367852,0.046367852
Colorado,CO,Cheyenne County,8,17,8017,Broncos,#fb4f14,1829,127,905,1076,0.11802974,0.841078067,-778,778,-0.723048327,0.723048327
Colorado,CO,Clear Creek County,8,19,8019,Broncos,#fb4f14,9303,2585,2426,5532,0.467281273,0.438539407,159,-159,0.028741866,-0.028741866
Colorado,CO,Conejos County,8,21,8021,Broncos,#fb4f14,8130,1753,1885,3970,0.441561713,0.474811083,-132,132,-0.03324937,0.03324937
Colorado,CO,Costilla County,8,23,8023,Broncos,#fb4f14,3584,1109,581,1820,0.609340659,0.319230769,528,-528,0.29010989,-0.29010989
Colorado,CO,Crowley County,8,25,8025,Broncos,#fb4f14,5562,336,1069,1511,0.222369292,0.707478491,-733,733,-0.485109199,0.485109199
Colorado,CO,Custer County,8,27,8027,Broncos,#fb4f14,4445,797,2059,3064,0.260117493,0.671997389,-1262,1262,-0.411879896,0.411879896
Colorado,CO,Delta County,8,29,8029,Broncos,#fb4f14,29979,4048,11584,16661,0.242962607,0.695276394,-7536,7536,-0.452313787,0.452313787
Colorado,CO,Denver County,8,31,8031,Broncos,#fb4f14,682545,174611,43637,232291,0.751690767,0.187854889,130974,-130974,0.563835878,-0.563835878
Colorado,CO,Dolores County,8,33,8033,Broncos,#fb4f14,1978,227,936,1230,0.184552846,0.76097561,-709,709,-0.576422764,0.576422764
Colorado,CO,Douglas County,8,35,8035,Broncos,#fb4f14,322387,67045,100178,182918,0.366530358,0.547666167,-33133,33133,-0.181135809,0.181135809
Colorado,CO,Eagle County,8,37,8037,Broncos,#fb4f14,53605,12652,8153,22611,0.559550661,0.36057671,4499,-4499,0.198973951,-0.198973951
Colorado,CO,Elbert County,8,39,8039,Broncos,#fb4f14,24735,3056,11536,15689,0.194786156,0.735292243,-8480,8480,-0.540506087,0.540506087
Colorado,CO,El Paso County,8,41,8041,Broncos,#fb4f14,674471,105807,176506,313273,0.337746949,0.563425511,-70699,70699,-0.225678562,0.225678562
Colorado,CO,Fremont County,8,43,8043,Broncos,#fb4f14,46692,5275,15066,21880,0.241087751,0.68857404,-9791,9791,-0.447486289,0.447486289
Colorado,CO,Garfield County,8,45,8045,Broncos,#fb4f14,58095,11205,13071,26328,0.425592525,0.496467639,-1866,1866,-0.070875114,0.070875114
Colorado,CO,Gilpin County,8,47,8047,Broncos,#fb4f14,5828,1634,1564,3574,0.457190823,0.437604924,70,-70,0.019585898,-0.019585898
Colorado,CO,Grand County,8,49,8049,Broncos,#fb4f14,14615,3319,4467,8513,0.38987431,0.524726888,-1148,1148,-0.134852578,0.134852578
Colorado,CO,Gunnison County,8,51,8051,Broncos,#fb4f14,16067,5068,3250,9299,0.545004839,0.349499946,1818,-1818,0.195504893,-0.195504893
Colorado,CO,Hinsdale County,8,53,8053,Broncos,#fb4f14,774,197,339,589,0.334465195,0.575551783,-142,142,-0.241086587,0.241086587
Colorado,CO,Huerfano County,8,55,8055,Broncos,#fb4f14,6492,1631,1875,3772,0.432396607,0.497083775,-244,244,-0.064687169,0.064687169
Colorado,CO,Jackson County,8,57,8057,Broncos,#fb4f14,1356,171,628,862,0.19837587,0.728538283,-457,457,-0.530162413,0.530162413
Colorado,CO,Jefferson County,8,59,8059,Broncos,#fb4f14,565524,151885,130233,309529,0.490697156,0.420745714,21652,-21652,0.069951442,-0.069951442
Colorado,CO,Kiowa County,8,61,8061,Broncos,#fb4f14,1423,91,726,853,0.106682298,0.851113716,-635,635,-0.744431419,0.744431419
Colorado,CO,Kit Carson County,8,63,8063,Broncos,#fb4f14,7758,526,2894,3613,0.145585386,0.800996402,-2368,2368,-0.655411016,0.655411016
Colorado,CO,Lake County,8,65,8065,Broncos,#fb4f14,7485,1600,1264,3175,0.503937008,0.398110236,336,-336,0.105826772,-0.105826772
Colorado,CO,La Plata County,8,67,8067,Broncos,#fb4f14,54688,15300,12471,30722,0.498014452,0.405930603,2829,-2829,0.092083849,-0.092083849
Colorado,CO,Larimer County,8,69,8069,Broncos,#fb4f14,333577,92170,82624,193897,0.475355472,0.426123148,9546,-9546,0.049232324,-0.049232324
Colorado,CO,Las Animas County,8,71,8071,Broncos,#fb4f14,14058,2614,3656,6693,0.390557299,0.546242343,-1042,1042,-0.155685044,0.155685044
Colorado,CO,Lincoln County,8,73,8073,Broncos,#fb4f14,5557,399,1873,2402,0.166111574,0.779766861,-1474,1474,-0.613655287,0.613655287
Colorado,CO,Logan County,8,75,8075,Broncos,#fb4f14,22036,1843,7272,9702,0.189960833,0.749536178,-5429,5429,-0.559575345,0.559575345
Colorado,CO,Mesa County,8,77,8077,Broncos,#fb4f14,148513,20958,48129,74876,0.279902773,0.642782734,-27171,27171,-0.362879962,0.362879962
Colorado,CO,Mineral County,8,79,8079,Broncos,#fb4f14,726,237,344,652,0.363496933,0.527607362,-107,107,-0.164110429,0.164110429
Colorado,CO,Moffat County,8,81,8081,Broncos,#fb4f14,12937,874,5293,6510,0.134254992,0.813056836,-4419,4419,-0.678801843,0.678801843
Colorado,CO,Montezuma County,8,83,8083,Broncos,#fb4f14,26168,3920,7771,12706,0.308515662,0.611600819,-3851,3851,-0.303085157,0.303085157
Colorado,CO,Montrose County,8,85,8085,Broncos,#fb4f14,40946,5438,14303,21070,0.258092074,0.678832463,-8865,8865,-0.420740389,0.420740389
Colorado,CO,Morgan County,8,87,8087,Broncos,#fb4f14,28360,3128,8104,11888,0.263122476,0.681695828,-4976,4976,-0.418573351,0.418573351
Colorado,CO,Otero County,8,89,8089,Broncos,#fb4f14,18343,1719,2988,5038,0.341206828,0.593092497,-1269,1269,-0.251885669,0.251885669
Colorado,CO,Ouray County,8,91,8091,Broncos,#fb4f14,4691,1690,1337,3287,0.514146638,0.406753879,353,-353,0.107392759,-0.107392759
Colorado,CO,Park County,8,93,8093,Broncos,#fb4f14,16510,3351,6053,10245,0.327086384,0.590824793,-2702,2702,-0.263738409,0.263738409
Colorado,CO,Phillips County,8,95,8095,Broncos,#fb4f14,4349,436,1791,2332,0.186963979,0.768010292,-1355,1355,-0.581046312,0.581046312
Colorado,CO,Pitkin County,8,97,8097,Broncos,#fb4f14,17787,7239,2522,10387,0.696928853,0.242803504,4717,-4717,0.454125349,-0.454125349
Colorado,CO,Prowers County,8,99,8099,Broncos,#fb4f14,11954,1173,3508,4978,0.235636802,0.704700683,-2335,2335,-0.469063881,0.469063881
Colorado,CO,Pueblo County,8,101,8101,Broncos,#fb4f14,163591,27945,27746,60112,0.46488222,0.461571733,199,-199,0.003310487,-0.003310487
Colorado,CO,Rio Blanco County,8,103,8103,Broncos,#fb4f14,6571,433,2782,3436,0.126018626,0.809662398,-2349,2349,-0.683643772,0.683643772
Colorado,CO,Rio Grande County,8,105,8105,Broncos,#fb4f14,11543,1985,3060,5488,0.361698251,0.557580175,-1075,1075,-0.195881924,0.195881924
Colorado,CO,Routt County,8,107,8107,Broncos,#fb4f14,24130,7487,5149,13772,0.543639268,0.373874528,2338,-2338,0.16976474,-0.16976474
Colorado,CO,Saguache County,8,109,8109,Broncos,#fb4f14,6251,1345,1109,2707,0.496859993,0.409678611,236,-236,0.087181382,-0.087181382
Colorado,CO,San Juan County,8,111,8111,Broncos,#fb4f14,701,265,215,506,0.523715415,0.424901186,50,-50,0.098814229,-0.098814229
Colorado,CO,San Miguel County,8,113,8113,Broncos,#fb4f14,7879,2960,1030,4311,0.686615634,0.238923684,1930,-1930,0.447691951,-0.447691951
Colorado,CO,Sedgwick County,8,115,8115,Broncos,#fb4f14,2399,267,1015,1364,0.195747801,0.744134897,-748,748,-0.548387097,0.548387097
Colorado,CO,Summit County,8,117,8117,Broncos,#fb4f14,30257,9502,5064,16061,0.591619451,0.315297927,4438,-4438,0.276321524,-0.276321524
Colorado,CO,Teller County,8,119,8119,Broncos,#fb4f14,23385,3547,9580,14203,0.249735971,0.674505386,-6033,6033,-0.424769415,0.424769415
Colorado,CO,Washington County,8,121,8121,Broncos,#fb4f14,4864,289,2284,2708,0.106720827,0.843426883,-1995,1995,-0.736706056,0.736706056
Colorado,CO,Weld County,8,123,8123,Broncos,#fb4f14,285174,45869,75882,133790,0.342843262,0.567172434,-30013,30013,-0.224329173,0.224329173
Colorado,CO,Yuma County,8,125,8125,Broncos,#fb4f14,10146,701,3755,4664,0.150300172,0.805102916,-3054,3054,-0.654802744,0.654802744
Connecticut,CT,Fairfield County,9,1,9001,Giants,#0b2265,948053,238723,155457,410279,0.581855274,0.378905574,83266,-83266,0.2029497,-0.2029497
Connecticut,CT,Hartford County,9,3,9003,Patriots,#c60c30,895841,233789,147912,399219,0.585615915,0.370503408,85877,-85877,0.215112507,-0.215112507
Connecticut,CT,Litchfield County,9,5,9005,Patriots,#c60c30,183603,39836,53376,97434,0.40885112,0.547816984,-13540,13540,-0.138965864,0.138965864
Connecticut,CT,Middlesex County,9,7,9007,Patriots,#c60c30,164063,45306,38847,88402,0.512499717,0.439435759,6459,-6459,0.073063958,-0.073063958
Connecticut,CT,New Haven County,9,9,9009,Giants,#0b2265,859470,203601,158373,375909,0.541623106,0.421306752,45228,-45228,0.120316353,-0.120316353
Connecticut,CT,New London County,9,11,9011,Patriots,#c60c30,271863,62951,54574,124527,0.505520891,0.438250339,8377,-8377,0.067270552,-0.067270552
Connecticut,CT,Tolland County,9,13,9013,Patriots,#c60c30,151420,38450,33989,77069,0.49890358,0.441020384,4461,-4461,0.057883196,-0.057883196
Connecticut,CT,Windham County,9,15,9015,Patriots,#c60c30,116573,21776,25738,50703,0.42948149,0.507622823,-3962,3962,-0.078141333,0.078141333
Delaware,DE,Kent County,10,1,10001,Eagles,#004953,173533,33347,36989,74253,0.4490997,0.498148223,-3642,3642,-0.049048523,0.049048523
Delaware,DE,New Castle County,10,3,10003,Eagles,#004953,556779,162905,85507,261468,0.623039913,0.327026634,77398,-77398,0.296013279,-0.296013279
Delaware,DE,Sussex County,10,5,10005,Ravens,#241773,215622,39329,62607,105814,0.371680496,0.591670289,-23278,23278,-0.219989793,0.219989793
District of Columbia,DC,District of Columbia,11,1,11001,Redskins,#773141,672228,260223,11553,280272,0.928465919,0.041220671,248670,-248670,0.887245247,-0.887245247
District of Columbia,DC,#N/A,11,31,11031,Redskins,#773141,#N/A,#N/A,#N/A,#N/A,#N/A,#N/A,#N/A,#N/A,#N/A,#N/A
Florida,FL,Alachua County,12,1,12001,Dolphins,#008e97,259964,75370,46584,127827,0.58962504,0.36443005,28786,-28786,0.22519499,-0.22519499
Florida,FL,Baker County,12,3,12003,Jaguars,#9f792c,27420,2112,10294,12634,0.167167959,0.814785499,-8182,8182,-0.64761754,0.64761754
Florida,FL,Bay County,12,5,12005,Saints,#9f8958,181635,21689,62010,87151,0.248866909,0.711523677,-40321,40321,-0.462656768,0.462656768
Florida,FL,Bradford County,12,7,12007,Jaguars,#9f792c,26928,2924,8913,12098,0.241692842,0.736733344,-5989,5989,-0.495040503,0.495040503
Florida,FL,Brevard County,12,9,12009,Dolphins,#008e97,568088,119525,181620,314337,0.380244769,0.577787534,-62095,62095,-0.197542765,0.197542765
Florida,FL,Broward County,12,11,12011,Dolphins,#008e97,1896425,546956,258521,822837,0.664719744,0.314182517,288435,-288435,0.350537227,-0.350537227
Florida,FL,Calhoun County,12,13,12013,Cowboys,#002244,14462,1236,4647,6067,0.20372507,0.765946926,-3411,3411,-0.562221856,0.562221856
Florida,FL,Charlotte County,12,15,12015,Buccaneers,#D50a0a,173115,33421,60196,96323,0.346968014,0.624939007,-26775,26775,-0.277970993,0.277970993
Florida,FL,Citrus County,12,17,12017,Buccaneers,#D50a0a,141058,22765,54377,79590,0.286028396,0.683213972,-31612,31612,-0.397185576,0.397185576
Florida,FL,Clay County,12,19,12019,Jaguars,#9f792c,203967,27768,74898,106363,0.261068229,0.704173444,-47130,47130,-0.443105215,0.443105215
Florida,FL,Collier County,12,21,12021,Dolphins,#008e97,357305,60941,105297,170505,0.357414739,0.617559602,-44356,44356,-0.260144864,0.260144864
Florida,FL,Columbia County,12,23,12023,Jaguars,#9f792c,68348,7599,20359,28696,0.264810427,0.709471703,-12760,12760,-0.444661277,0.444661277
Florida,FL,DeSoto County,12,27,12027,Buccaneers,#D50a0a,35458,3761,6744,10761,0.349502834,0.626707555,-2983,2983,-0.277204721,0.277204721
Florida,FL,Dixie County,12,29,12029,Packers,#203731,16203,1270,5822,7202,0.176339906,0.808386559,-4552,4552,-0.632046654,0.632046654
Florida,FL,Duval County,12,31,12031,Jaguars,#9f792c,913010,203627,210061,428734,0.474949502,0.489956477,-6434,6434,-0.015006974,0.015006974
Florida,FL,Escambia County,12,33,12033,Saints,#9f8958,311003,57114,88370,151609,0.37671906,0.582880964,-31256,31256,-0.206161903,0.206161903
Florida,FL,Flagler County,12,35,12035,Cowboys,#002244,105392,21985,33804,57413,0.382927212,0.588786512,-11819,11819,-0.2058593,0.2058593
Florida,FL,Franklin County,12,37,12037,Dolphins,#008e97,11761,1738,4119,6003,0.289521906,0.686156922,-2381,2381,-0.396635016,0.396635016
Florida,FL,Gadsden County,12,39,12039,Cowboys,#002244,46036,14994,6721,22079,0.679106844,0.304406902,8273,-8273,0.374699941,-0.374699941
Florida,FL,Gilchrist County,12,41,12041,Buccaneers,#D50a0a,17199,1457,6740,8418,0.173081492,0.800665241,-5283,5283,-0.627583749,0.627583749
Florida,FL,Glades County,12,43,12043,Dolphins,#008e97,13670,1271,2996,4355,0.29184845,0.687944891,-1725,1725,-0.396096441,0.396096441
Florida,FL,Gulf County,12,45,12045,Saints,#9f8958,15871,1715,5320,7279,0.235609287,0.730869625,-3605,3605,-0.495260338,0.495260338
Florida,FL,Hamilton County,12,47,12047,Cowboys,#002244,14295,1899,3439,5451,0.348376445,0.630893414,-1540,1540,-0.282516969,0.282516969
Florida,FL,Hardee County,12,49,12049,Buccaneers,#D50a0a,27502,2147,5238,7577,0.283357529,0.691302626,-3091,3091,-0.407945097,0.407945097
Florida,FL,Hendry County,12,51,12051,Dolphins,#008e97,39119,4610,6192,11106,0.415090942,0.557536467,-1582,1582,-0.142445525,0.142445525
Florida,FL,Hernando County,12,53,12053,Buccaneers,#D50a0a,178439,31818,59029,93878,0.338929249,0.628784167,-27211,27211,-0.289854918,0.289854918
Florida,FL,Highlands County,12,55,12055,Buccaneers,#D50a0a,99491,14901,29509,45589,0.326855162,0.647283336,-14608,14608,-0.320428173,0.320428173
Florida,FL,Hillsborough County,12,57,12057,Buccaneers,#D50a0a,1349050,306422,265928,595072,0.514932647,0.446883738,40494,-40494,0.068048908,-0.068048908
Florida,FL,Holmes County,12,59,12059,Saints,#9f8958,19324,852,7476,8506,0.10016459,0.878909005,-6624,6624,-0.778744416,0.778744416
Florida,FL,Indian River County,12,61,12061,Dolphins,#008e97,147919,28997,48564,79897,0.362929772,0.607832584,-19567,19567,-0.244902812,0.244902812
Florida,FL,Jackson County,12,63,12063,Saints,#9f8958,48599,6383,14231,20997,0.303995809,0.67776349,-7848,7848,-0.373767681,0.373767681
Florida,FL,Jefferson County,12,65,12065,Dolphins,#008e97,14081,3537,3930,7641,0.462897527,0.514330585,-393,393,-0.051433059,0.051433059
Florida,FL,Lafayette County,12,67,12067,Jaguars,#9f792c,8663,515,2795,3375,0.152592593,0.828148148,-2280,2280,-0.675555556,0.675555556
Florida,FL,Lake County,12,69,12069,Dolphins,#008e97,325875,62597,101888,169898,0.36843871,0.599700997,-39291,39291,-0.231262287,0.231262287
Florida,FL,Lee County,12,71,12071,Dolphins,#008e97,701982,124725,191141,325797,0.382830413,0.586687416,-66416,66416,-0.203857003,0.203857003
Florida,FL,Leon County,12,73,12073,Dolphins,#008e97,286272,91936,53777,151925,0.605140694,0.353970709,38159,-38159,0.251169985,-0.251169985
Florida,FL,Levy County,12,75,12075,Buccaneers,#D50a0a,39832,5091,13758,19367,0.26286983,0.710383642,-8667,8667,-0.447513812,0.447513812
Florida,FL,Liberty County,12,77,12077,Jaguars,#9f792c,8331,651,2542,3295,0.197572079,0.771471927,-1891,1891,-0.573899848,0.573899848
Florida,FL,Madison County,12,79,12079,Dolphins,#008e97,18408,3526,4849,8503,0.414677173,0.570269317,-1323,1323,-0.155592144,0.155592144
Florida,FL,Manatee County,12,81,12081,Buccaneers,#D50a0a,363369,71066,101681,178521,0.398082018,0.569574448,-30615,30615,-0.171492429,0.171492429
Florida,FL,Marion County,12,83,12083,Dolphins,#008e97,343254,61958,107710,174485,0.355090695,0.617302347,-45752,45752,-0.262211651,0.262211651
Florida,FL,Martin County,12,85,12085,Dolphins,#008e97,156283,30158,53182,85741,0.35173371,0.620263351,-23024,23024,-0.268529642,0.268529642
Florida,FL,Miami-Dade County,12,86,12086,Dolphins,#008e97,2693117,623006,333666,978670,0.636584344,0.340938212,289340,-289340,0.295646132,-0.295646132
Florida,FL,Monroe County,12,87,12087,Dolphins,#008e97,77482,18949,21885,42434,0.446552293,0.515742094,-2936,2936,-0.069189801,0.069189801
Florida,FL,Nassau County,12,89,12089,Jaguars,#9f792c,78444,10849,34221,46537,0.23312633,0.735350366,-23372,23372,-0.502224037,0.502224037
Florida,FL,Okaloosa County,12,91,12091,Saints,#9f8958,198664,23711,71788,100657,0.235562355,0.713194313,-48077,48077,-0.477631958,0.477631958
Florida,FL,Okeechobee County,12,93,12093,Dolphins,#008e97,39469,3953,9342,13632,0.28997946,0.685299296,-5389,5389,-0.395319836,0.395319836
Florida,FL,Orange County,12,95,12095,Dolphins,#008e97,1288126,329579,195091,545800,0.603845731,0.357440454,134488,-134488,0.246405277,-0.246405277
Florida,FL,Osceola County,12,97,12097,Cowboys,#002244,323993,85287,50252,139981,0.609275545,0.358991577,35035,-35035,0.250283967,-0.250283967
Florida,FL,Palm Beach County,12,99,12099,Dolphins,#008e97,1422789,371411,270762,657235,0.565111414,0.411971365,100649,-100649,0.153140049,-0.153140049
Florida,FL,Pasco County,12,101,12101,Buccaneers,#D50a0a,497909,89998,141943,240814,0.373724119,0.589430017,-51945,51945,-0.215705897,0.215705897
Florida,FL,Pinellas County,12,103,12103,Buccaneers,#D50a0a,949827,233327,238746,491520,0.474704997,0.48572998,-5419,5419,-0.011024984,0.011024984
Florida,FL,Polk County,12,105,12105,Buccaneers,#D50a0a,650092,117182,157216,283828,0.41286272,0.553912933,-40034,40034,-0.141050214,0.141050214
Florida,FL,Putnam County,12,107,12107,Jaguars,#9f792c,72023,9920,21873,32652,0.303809874,0.669882396,-11953,11953,-0.366072522,0.366072522
Florida,FL,St. Johns County,12,109,12109,Jaguars,#9f792c,226640,43037,88633,136392,0.315539035,0.649840167,-45596,45596,-0.334301132,0.334301132
Florida,FL,St. Lucie County,12,111,12111,Dolphins,#008e97,298563,66812,70248,140731,0.4747497,0.499165074,-3436,3436,-0.024415374,0.024415374
Florida,FL,Santa Rosa County,12,113,12113,Saints,#9f8958,167040,18398,65126,87432,0.210426389,0.744876018,-46728,46728,-0.534449629,0.534449629
Florida,FL,Sarasota County,12,115,12115,Buccaneers,#D50a0a,405549,97676,124098,228509,0.427449247,0.543077078,-26422,26422,-0.115627831,0.115627831
Florida,FL,Seminole County,12,117,12117,Dolphins,#008e97,449144,105611,109265,224377,0.470685498,0.48697059,-3654,3654,-0.016285092,0.016285092
Florida,FL,Sumter County,12,119,12119,Buccaneers,#D50a0a,118891,22631,52722,76649,0.295254994,0.687836762,-30091,30091,-0.392581769,0.392581769
Florida,FL,Suwannee County,12,121,12121,Dolphins,#008e97,43760,3955,14281,18675,0.211780455,0.764712182,-10326,10326,-0.552931727,0.552931727
Florida,FL,Taylor County,12,123,12123,Buccaneers,#D50a0a,22493,2149,6923,9279,0.231598233,0.746093329,-4774,4774,-0.514495096,0.514495096
Florida,FL,Union County,12,125,12125,Jaguars,#9f792c,15234,1014,4567,5693,0.178113473,0.802213244,-3553,3553,-0.624099772,0.624099772
Florida,FL,Volusia County,12,127,12127,Dolphins,#008e97,517887,108793,142763,260304,0.41794594,0.5484472,-33970,33970,-0.13050126,0.13050126
Florida,FL,Wakulla County,12,129,12129,Buccaneers,#D50a0a,31535,4348,10507,15344,0.283368092,0.684762774,-6159,6159,-0.401394682,0.401394682
Florida,FL,Walton County,12,131,12131,Saints,#9f8958,63508,6861,25695,33559,0.204445901,0.765666438,-18834,18834,-0.561220537,0.561220537
Florida,FL,Washington County,12,133,12133,Saints,#9f8958,24687,2261,8630,11144,0.202889447,0.774407753,-6369,6369,-0.571518306,0.571518306
Georgia,GA,Appling County,13,1,13001,Falcons,#a71930,18454,1434,5492,7003,0.204769385,0.784235328,-4058,4058,-0.579465943,0.579465943
Georgia,GA,Atkinson County,13,3,13003,Falcons,#a71930,8398,696,1873,2604,0.267281106,0.719278034,-1177,1177,-0.451996928,0.451996928
Georgia,GA,Bacon County,13,5,13005,Falcons,#a71930,11299,607,3356,4010,0.151371571,0.836907731,-2749,2749,-0.68553616,0.68553616
Georgia,GA,Baker County,13,7,13007,Falcons,#a71930,3180,650,775,1440,0.451388889,0.538194444,-125,125,-0.086805556,0.086805556
Georgia,GA,Baldwin County,13,9,13009,Falcons,#a71930,45459,7965,7691,16075,0.495489891,0.47844479,274,-274,0.017045101,-0.017045101
Georgia,GA,Banks County,13,11,13011,Falcons,#a71930,18495,684,6130,6946,0.098473942,0.882522315,-5446,5446,-0.784048373,0.784048373
Georgia,GA,Barrow County,13,13,13013,Falcons,#a71930,75370,6580,21105,28828,0.228250312,0.732100735,-14525,14525,-0.503850423,0.503850423
Georgia,GA,Bartow County,13,15,13015,Falcons,#a71930,102747,8204,29879,39263,0.208949902,0.760996358,-21675,21675,-0.552046456,0.552046456
Georgia,GA,Ben Hill County,13,17,13017,Falcons,#a71930,17403,2098,3734,5923,0.354212392,0.630423772,-1636,1636,-0.276211379,0.276211379
Georgia,GA,Berrien County,13,19,13019,Falcons,#a71930,18963,1041,5408,6563,0.158616486,0.824013409,-4367,4367,-0.665396922,0.665396922
Georgia,GA,Bibb County,13,21,13021,Falcons,#a71930,153721,34383,22589,58327,0.589486859,0.387282048,11794,-11794,0.202204811,-0.202204811
Georgia,GA,Bleckley County,13,23,13023,Falcons,#a71930,12243,1094,3717,4934,0.221726794,0.753344143,-2623,2623,-0.531617349,0.531617349
Georgia,GA,Brantley County,13,25,13025,Falcons,#a71930,18455,619,5561,6285,0.098488465,0.884805091,-4942,4942,-0.786316627,0.786316627
Georgia,GA,Brooks County,13,27,13027,Falcons,#a71930,15658,2504,3679,6268,0.39948947,0.586949585,-1175,1175,-0.187460115,0.187460115
Georgia,GA,Bryan County,13,29,13029,Falcons,#a71930,35137,4010,10513,15063,0.266215229,0.697935338,-6503,6503,-0.431720109,0.431720109
Georgia,GA,Bulloch County,13,31,13031,Falcons,#a71930,72651,8812,14476,24151,0.36487102,0.59939547,-5664,5664,-0.23452445,0.23452445
Georgia,GA,Burke County,13,33,13033,Falcons,#a71930,22745,4730,4491,9350,0.505882353,0.480320856,239,-239,0.025561497,-0.025561497
Georgia,GA,Butts County,13,35,13035,Falcons,#a71930,23593,2566,6717,9477,0.270760789,0.708768598,-4151,4151,-0.438007808,0.438007808
Georgia,GA,Calhoun County,13,37,13037,Falcons,#a71930,6479,1178,829,2023,0.58230351,0.409787444,349,-349,0.172516065,-0.172516065
Georgia,GA,Camden County,13,39,13039,Jaguars,#9f792c,52102,5914,12287,18825,0.314156707,0.652695883,-6373,6373,-0.338539177,0.338539177
Georgia,GA,Candler County,13,43,13043,Falcons,#a71930,10886,1023,2661,3757,0.272291722,0.708277881,-1638,1638,-0.435986159,0.435986159
Georgia,GA,Carroll County,13,45,13045,Falcons,#a71930,114545,12422,29983,43744,0.283970373,0.685419715,-17561,17561,-0.401449342,0.401449342
Georgia,GA,Catoosa County,13,47,13047,Falcons,#a71930,66050,4769,20860,26510,0.179894379,0.786872878,-16091,16091,-0.606978499,0.606978499
Georgia,GA,Charlton County,13,49,13049,Jaguars,#9f792c,12965,1004,2950,4008,0.250499002,0.736027944,-1946,1946,-0.485528942,0.485528942
Georgia,GA,Chatham County,13,51,13051,Falcons,#a71930,286956,58998,43649,106013,0.556516654,0.411732523,15349,-15349,0.14478413,-0.14478413
Georgia,GA,Chattahoochee County,13,53,13053,Falcons,#a71930,11368,593,746,1384,0.428468208,0.539017341,-153,153,-0.110549133,0.110549133
Georgia,GA,Chattooga County,13,55,13055,Falcons,#a71930,24922,1612,6457,8246,0.195488722,0.783046325,-4845,4845,-0.587557604,0.587557604
Georgia,GA,Cherokee County,13,57,13057,Falcons,#a71930,235900,25203,80611,110825,0.227412587,0.727371983,-55408,55408,-0.499959395,0.499959395
Georgia,GA,Clarke County,13,59,13059,Falcons,#a71930,123912,29514,12691,44221,0.667420456,0.286990344,16823,-16823,0.380430112,-0.380430112
Georgia,GA,Clay County,13,61,13061,Falcons,#a71930,3141,697,566,1271,0.548387097,0.445318647,131,-131,0.10306845,-0.10306845
Georgia,GA,Clayton County,13,63,13063,Falcons,#a71930,273955,75908,11740,89236,0.850643238,0.131561253,64168,-64168,0.719081985,-0.719081985
Georgia,GA,Clinch County,13,65,13065,Falcons,#a71930,6893,685,1724,2443,0.280392959,0.705689726,-1039,1039,-0.425296766,0.425296766
Georgia,GA,Cobb County,13,67,13067,Falcons,#a71930,741334,159416,152602,326424,0.488370953,0.467496263,6814,-6814,0.020874691,-0.020874691
Georgia,GA,Coffee County,13,69,13069,Falcons,#a71930,43108,4090,9575,13896,0.294329303,0.689047208,-5485,5485,-0.394717904,0.394717904
Georgia,GA,Colquitt County,13,71,13071,Falcons,#a71930,45844,3460,9892,13592,0.254561507,0.727781048,-6432,6432,-0.473219541,0.473219541
Georgia,GA,Columbia County,13,73,13073,Falcons,#a71930,144052,18863,43060,64190,0.293861972,0.670821,-24197,24197,-0.376959028,0.376959028
Georgia,GA,Cook County,13,75,13075,Falcons,#a71930,17124,1752,4175,6038,0.290162305,0.691454124,-2423,2423,-0.401291818,0.401291818
Georgia,GA,Coweta County,13,77,13077,Falcons,#a71930,138427,16572,42513,61315,0.270276441,0.693353992,-25941,25941,-0.42307755,0.42307755
Georgia,GA,Crawford County,13,79,13079,Falcons,#a71930,12388,1419,3632,5157,0.275159977,0.704285437,-2213,2213,-0.429125461,0.429125461
Georgia,GA,Crisp County,13,81,13081,Falcons,#a71930,22881,2835,4539,7500,0.378,0.6052,-1704,1704,-0.2272,0.2272
Georgia,GA,Dade County,13,83,13083,Falcons,#a71930,16264,965,5047,6238,0.154697018,0.809073421,-4082,4082,-0.654376403,0.654376403
Georgia,GA,Dawson County,13,85,13085,Falcons,#a71930,23312,1444,9880,11680,0.123630137,0.845890411,-8436,8436,-0.722260274,0.722260274
Georgia,GA,Decatur County,13,87,13087,Falcons,#a71930,27174,4104,6009,10238,0.400859543,0.586931041,-1905,1905,-0.186071498,0.186071498
Georgia,GA,DeKalb County,13,89,13089,Falcons,#a71930,734871,239131,47531,295871,0.808227234,0.160647715,191600,-191600,0.647579519,-0.647579519
Georgia,GA,Dodge County,13,91,13091,Falcons,#a71930,20882,1836,5021,6995,0.262473195,0.717798427,-3185,3185,-0.455325232,0.455325232
Georgia,GA,Dooly County,13,93,13093,Falcons,#a71930,14035,1860,1941,3836,0.484880083,0.505995829,-81,81,-0.021115746,0.021115746
Georgia,GA,Dougherty County,13,95,13095,Falcons,#a71930,91332,23224,10227,33925,0.684568902,0.301459101,12997,-12997,0.383109801,-0.383109801
Georgia,GA,Douglas County,13,97,13097,Falcons,#a71930,140733,30971,24803,57365,0.539893663,0.432371655,6168,-6168,0.107522008,-0.107522008
Georgia,GA,Early County,13,99,13099,Falcons,#a71930,10575,2165,2552,4782,0.45273944,0.533667921,-387,387,-0.080928482,0.080928482
Georgia,GA,Echols County,13,101,13101,Falcons,#a71930,4040,156,1006,1175,0.132765957,0.856170213,-850,850,-0.723404255,0.723404255
Georgia,GA,Effingham County,13,103,13103,Falcons,#a71930,57106,4851,17865,23395,0.207351998,0.763624706,-13014,13014,-0.556272708,0.556272708
Georgia,GA,Elbert County,13,105,13105,Falcons,#a71930,19364,2507,5269,7912,0.316860465,0.665950455,-2762,2762,-0.34908999,0.34908999
Georgia,GA,Emanuel County,13,107,13107,Falcons,#a71930,22708,2433,5330,7838,0.310410819,0.680020413,-2897,2897,-0.369609594,0.369609594
Georgia,GA,Evans County,13,109,13109,Falcons,#a71930,10787,1130,2404,3602,0.313714603,0.667406996,-1274,1274,-0.353692393,0.353692393
Georgia,GA,Fannin County,13,111,13111,Falcons,#a71930,24303,1920,9622,11764,0.163209793,0.817919075,-7702,7702,-0.654709283,0.654709283
Georgia,GA,Fayette County,13,113,13113,Falcons,#a71930,110714,23255,35034,60387,0.385099442,0.580157981,-11779,11779,-0.195058539,0.195058539
Georgia,GA,Floyd County,13,115,13115,Falcons,#a71930,96504,9127,24045,34250,0.266481752,0.702043796,-14918,14918,-0.435562044,0.435562044
Georgia,GA,Forsyth County,13,117,13117,Falcons,#a71930,212438,23427,69801,97314,0.240736174,0.717276034,-46374,46374,-0.476539861,0.476539861
Georgia,GA,Franklin County,13,119,13119,Falcons,#a71930,22311,1243,7054,8474,0.146683975,0.832428605,-5811,5811,-0.685744631,0.685744631
Georgia,GA,Fulton County,13,121,13121,Falcons,#a71930,1010562,281875,110372,407173,0.692273309,0.271069054,171503,-171503,0.421204255,-0.421204255
Georgia,GA,Gilmer County,13,123,13123,Falcons,#a71930,29400,1955,10465,12713,0.153779596,0.82317313,-8510,8510,-0.669393534,0.669393534
Georgia,GA,Glascock County,13,125,13125,Falcons,#a71930,3065,138,1235,1390,0.099280576,0.888489209,-1097,1097,-0.789208633,0.789208633
Georgia,GA,Glynn County,13,127,13127,Falcons,#a71930,83579,11738,21482,34041,0.344819482,0.631062542,-9744,9744,-0.28624306,0.28624306
Georgia,GA,Gordon County,13,129,13129,Falcons,#a71930,56574,3176,15171,18850,0.168488064,0.804827586,-11995,11995,-0.636339523,0.636339523
Georgia,GA,Grady County,13,131,13131,Falcons,#a71930,25205,3005,6047,9187,0.327092631,0.658212692,-3042,3042,-0.331120061,0.331120061
Georgia,GA,Greene County,13,133,13133,Falcons,#a71930,16710,3194,5488,8831,0.361680444,0.621447175,-2294,2294,-0.259766731,0.259766731
Georgia,GA,Gwinnett County,13,135,13135,Falcons,#a71930,895823,165063,146463,323931,0.509562222,0.452142586,18600,-18600,0.057419636,-0.057419636
Georgia,GA,Habersham County,13,137,13137,Falcons,#a71930,43996,2483,13184,16128,0.153955853,0.817460317,-10701,10701,-0.663504464,0.663504464
Georgia,GA,Hall County,13,139,13139,Falcons,#a71930,193535,16153,51681,70133,0.230319536,0.73689989,-35528,35528,-0.506580354,0.506580354
Georgia,GA,Hancock County,13,141,13141,Falcons,#a71930,8551,2695,841,3572,0.754479283,0.235442329,1854,-1854,0.519036954,-0.519036954
Georgia,GA,Haralson County,13,143,13143,Falcons,#a71930,28854,1474,9579,11317,0.130246532,0.846425731,-8105,8105,-0.716179199,0.716179199
Georgia,GA,Harris County,13,145,13145,Falcons,#a71930,33381,4082,11931,16392,0.249023914,0.727855051,-7849,7849,-0.478831137,0.478831137
Georgia,GA,Hart County,13,147,13147,Falcons,#a71930,25534,2583,7285,10077,0.256326288,0.722933413,-4702,4702,-0.466607125,0.466607125
Georgia,GA,Heard County,13,149,13149,Falcons,#a71930,11539,743,3370,4206,0.176652401,0.801236329,-2627,2627,-0.624583928,0.624583928
Georgia,GA,Henry County,13,151,13151,Falcons,#a71930,217739,49902,45641,98037,0.509011904,0.465548721,4261,-4261,0.043463182,-0.043463182
Georgia,GA,Houston County,13,153,13153,Falcons,#a71930,150033,22460,35351,59559,0.377105055,0.593545896,-12891,12891,-0.21644084,0.21644084
Georgia,GA,Irwin County,13,155,13155,Falcons,#a71930,9245,890,2711,3659,0.243235857,0.740912818,-1821,1821,-0.497676961,0.497676961
Georgia,GA,Jackson County,13,157,13157,Falcons,#a71930,63360,4469,21754,27057,0.165169827,0.804006357,-17285,17285,-0.63883653,0.63883653
Georgia,GA,Jasper County,13,159,13159,Falcons,#a71930,13635,1544,4353,6016,0.256648936,0.723570479,-2809,2809,-0.466921543,0.466921543
Georgia,GA,Jeff Davis County,13,161,13161,Falcons,#a71930,14920,901,4102,5089,0.177048536,0.80605227,-3201,3201,-0.629003734,0.629003734
Georgia,GA,Jefferson County,13,163,13163,Falcons,#a71930,16106,3809,3057,6934,0.549322181,0.44087107,752,-752,0.10845111,-0.10845111
Georgia,GA,Jenkins County,13,165,13165,Falcons,#a71930,8957,1108,1892,3034,0.365194463,0.623599209,-784,784,-0.258404746,0.258404746
Georgia,GA,Johnson County,13,167,13167,Falcons,#a71930,9656,1136,2519,3682,0.308527974,0.684139055,-1383,1383,-0.375611081,0.375611081
Georgia,GA,Jones County,13,169,13169,Falcons,#a71930,28494,3960,8304,12524,0.31619291,0.66304695,-4344,4344,-0.34685404,0.34685404
Georgia,GA,Lamar County,13,171,13171,Falcons,#a71930,18201,2267,5183,7575,0.299273927,0.684224422,-2916,2916,-0.384950495,0.384950495
Georgia,GA,Lanier County,13,173,13173,Falcons,#a71930,10312,805,1984,2861,0.28137015,0.693463824,-1179,1179,-0.412093674,0.412093674
Georgia,GA,Laurens County,13,175,13175,Falcons,#a71930,47731,6737,12401,19448,0.346410942,0.637649116,-5664,5664,-0.291238174,0.291238174
Georgia,GA,Lee County,13,177,13177,Falcons,#a71930,29202,3166,10641,14106,0.224443499,0.754359847,-7475,7475,-0.529916348,0.529916348
Georgia,GA,Liberty County,13,179,13179,Falcons,#a71930,62467,9531,6125,16082,0.592650168,0.380860589,3406,-3406,0.211789578,-0.211789578
Georgia,GA,Lincoln County,13,181,13181,Falcons,#a71930,7673,1271,2759,4100,0.31,0.672926829,-1488,1488,-0.362926829,0.362926829
Georgia,GA,Long County,13,183,13183,Falcons,#a71930,17731,1356,2623,4109,0.330007301,0.638354831,-1267,1267,-0.30834753,0.30834753
Georgia,GA,Lowndes County,13,185,13185,Falcons,#a71930,112865,14614,21308,36813,0.396979328,0.578817266,-6694,6694,-0.181837938,0.181837938
Georgia,GA,Lumpkin County,13,187,13187,Falcons,#a71930,31408,2216,9613,12324,0.179811749,0.78002272,-7397,7397,-0.60021097,0.60021097
Georgia,GA,McDuffie County,13,189,13189,Falcons,#a71930,21540,3699,5432,9268,0.399115235,0.586102719,-1733,1733,-0.186987484,0.186987484
Georgia,GA,McIntosh County,13,191,13191,Falcons,#a71930,13969,2298,3482,5893,0.389954183,0.590870524,-1184,1184,-0.200916341,0.200916341
Georgia,GA,Macon County,13,193,13193,Falcons,#a71930,13632,2705,1540,4287,0.630977373,0.359225566,1165,-1165,0.271751808,-0.271751808
Georgia,GA,Madison County,13,195,13195,Falcons,#a71930,28441,2423,9195,11945,0.202846379,0.76977815,-6772,6772,-0.566931771,0.566931771
Georgia,GA,Marion County,13,197,13197,Falcons,#a71930,8761,1213,1921,3183,0.381087025,0.603518693,-708,708,-0.222431668,0.222431668
Georgia,GA,Meriwether County,13,199,13199,Falcons,#a71930,21190,3800,5216,9181,0.413898268,0.568129833,-1416,1416,-0.154231565,0.154231565
Georgia,GA,Miller County,13,201,13201,Falcons,#a71930,5854,622,1888,2540,0.24488189,0.743307087,-1266,1266,-0.498425197,0.498425197
Georgia,GA,Mitchell County,13,205,13205,Falcons,#a71930,22574,3492,4272,7857,0.444444444,0.543718977,-780,780,-0.099274532,0.099274532
Georgia,GA,Monroe County,13,207,13207,Falcons,#a71930,27103,3570,8821,12675,0.281656805,0.695936884,-5251,5251,-0.414280079,0.414280079
Georgia,GA,Montgomery County,13,209,13209,Falcons,#a71930,8951,847,2668,3560,0.237921348,0.749438202,-1821,1821,-0.511516854,0.511516854
Georgia,GA,Morgan County,13,211,13211,Falcons,#a71930,18046,2658,6559,9435,0.281717011,0.69517753,-3901,3901,-0.413460519,0.413460519
Georgia,GA,Murray County,13,213,13213,Falcons,#a71930,39565,1799,10340,12422,0.1448237,0.832394139,-8541,8541,-0.68757044,0.68757044
Georgia,GA,Muscogee County,13,215,13215,Falcons,#a71930,200579,39602,26901,68320,0.579654567,0.39375,12701,-12701,0.185904567,-0.185904567
Georgia,GA,Newton County,13,217,13217,Falcons,#a71930,105473,21936,20907,43787,0.500970608,0.477470482,1029,-1029,0.023500126,-0.023500126
Georgia,GA,Oconee County,13,219,13219,Falcons,#a71930,35965,5253,12885,19030,0.276037835,0.677088807,-7632,7632,-0.401050972,0.401050972
Georgia,GA,Oglethorpe County,13,221,13221,Falcons,#a71930,14871,1829,4622,6650,0.275037594,0.695037594,-2793,2793,-0.42,0.42
Georgia,GA,Paulding County,13,223,13223,Falcons,#a71930,152238,18004,44646,64601,0.278695376,0.691103853,-26642,26642,-0.412408477,0.412408477
Georgia,GA,Peach County,13,225,13225,Falcons,#a71930,26720,5083,5405,10699,0.47509113,0.505187401,-322,322,-0.030096271,0.030096271
Georgia,GA,Pickens County,13,227,13227,Falcons,#a71930,30309,1977,11651,13982,0.141396081,0.833285653,-9674,9674,-0.691889572,0.691889572
Georgia,GA,Pierce County,13,229,13229,Falcons,#a71930,19103,903,6301,7297,0.123749486,0.86350555,-5398,5398,-0.739756064,0.739756064
Georgia,GA,Pike County,13,231,13231,Falcons,#a71930,17941,1239,7273,8675,0.142824207,0.838386167,-6034,6034,-0.69556196,0.69556196
Georgia,GA,Polk County,13,233,13233,Falcons,#a71930,41524,2863,11006,14158,0.202217827,0.777369685,-8143,8143,-0.575151858,0.575151858
Georgia,GA,Pulaski County,13,235,13235,Falcons,#a71930,11396,1104,2436,3598,0.306837132,0.677042802,-1332,1332,-0.37020567,0.37020567
Georgia,GA,Putnam County,13,237,13237,Falcons,#a71930,21353,2745,6516,9431,0.291061393,0.690912947,-3771,3771,-0.399851553,0.399851553
Georgia,GA,Quitman County,13,239,13239,Falcons,#a71930,2302,461,575,1044,0.441570881,0.550766284,-114,114,-0.109195402,0.109195402
Georgia,GA,Rabun County,13,241,13241,Falcons,#a71930,16281,1443,6287,7949,0.181532268,0.790917096,-4844,4844,-0.609384828,0.609384828
Georgia,GA,Randolph County,13,243,13243,Falcons,#a71930,7193,1597,1270,2895,0.55164076,0.438687392,327,-327,0.112953368,-0.112953368
Georgia,GA,Richmond County,13,245,13245,Falcons,#a71930,201793,48707,24441,74952,0.649842566,0.326088697,24266,-24266,0.323753869,-0.323753869
Georgia,GA,Rockdale County,13,247,13247,Falcons,#a71930,88856,23206,13463,37589,0.617361462,0.358163292,9743,-9743,0.25919817,-0.25919817
Georgia,GA,Schley County,13,249,13249,Falcons,#a71930,5168,401,1472,1909,0.210057622,0.771084337,-1071,1071,-0.561026716,0.561026716
Georgia,GA,Screven County,13,251,13251,Falcons,#a71930,14162,2300,3305,5699,0.403579575,0.579926303,-1005,1005,-0.176346727,0.176346727
Georgia,GA,Seminole County,13,253,13253,Falcons,#a71930,8647,1186,2343,3577,0.331562762,0.655018172,-1157,1157,-0.32345541,0.32345541
Georgia,GA,Spalding County,13,255,13255,Falcons,#a71930,64051,9347,15636,25940,0.360331534,0.602775636,-6289,6289,-0.242444102,0.242444102
Georgia,GA,Stephens County,13,257,13257,Falcons,#a71930,25586,1835,7682,9760,0.188012295,0.787090164,-5847,5847,-0.599077869,0.599077869
Georgia,GA,Stewart County,13,259,13259,Falcons,#a71930,5851,1220,805,2053,0.594252314,0.392109109,415,-415,0.202143205,-0.202143205
Georgia,GA,Sumter County,13,261,13261,Falcons,#a71930,30779,5520,5275,10973,0.503052948,0.480725417,245,-245,0.022327531,-0.022327531
Georgia,GA,Talbot County,13,263,13263,Falcons,#a71930,6337,2001,1196,3243,0.617021277,0.368794326,805,-805,0.24822695,-0.24822695
Georgia,GA,Taliaferro County,13,265,13265,Falcons,#a71930,1639,545,349,897,0.607580825,0.389074693,196,-196,0.218506132,-0.218506132
Georgia,GA,Tattnall County,13,267,13267,Falcons,#a71930,25229,1678,5092,6879,0.243930804,0.74022387,-3414,3414,-0.496293066,0.496293066
Georgia,GA,Taylor County,13,269,13269,Falcons,#a71930,8330,1295,2062,3402,0.380658436,0.606114051,-767,767,-0.225455614,0.225455614
Georgia,GA,Telfair County,13,271,13271,Falcons,#a71930,16400,1313,2449,3794,0.346072746,0.645492884,-1136,1136,-0.299420137,0.299420137
Georgia,GA,Terrell County,13,273,13273,Falcons,#a71930,9113,2267,1872,4179,0.542474276,0.447954056,395,-395,0.09452022,-0.09452022
Georgia,GA,Thomas County,13,275,13275,Falcons,#a71930,45063,7138,11225,18730,0.38109984,0.599305926,-4087,4087,-0.218206086,0.218206086
Georgia,GA,Tift County,13,277,13277,Falcons,#a71930,40764,3892,8680,12796,0.304157549,0.67833698,-4788,4788,-0.374179431,0.374179431
Georgia,GA,Toombs County,13,279,13279,Falcons,#a71930,27241,2338,6612,9108,0.256697409,0.725955204,-4274,4274,-0.469257795,0.469257795
Georgia,GA,Towns County,13,281,13281,Falcons,#a71930,11182,1206,5377,6726,0.179304193,0.799435028,-4171,4171,-0.620130836,0.620130836
Georgia,GA,Treutlen County,13,283,13283,Falcons,#a71930,6785,860,1808,2700,0.318518519,0.66962963,-948,948,-0.351111111,0.351111111
Georgia,GA,Troup County,13,285,13285,Falcons,#a71930,69763,9597,15643,25793,0.372077695,0.606482379,-6046,6046,-0.234404683,0.234404683
Georgia,GA,Turner County,13,287,13287,Falcons,#a71930,8214,1243,2094,3390,0.366666667,0.617699115,-851,851,-0.251032448,0.251032448
Georgia,GA,Twiggs County,13,289,13289,Falcons,#a71930,8390,1970,2034,4053,0.486059709,0.501850481,-64,64,-0.015790772,0.015790772
Georgia,GA,Union County,13,291,13291,Falcons,#a71930,22267,1962,9849,12039,0.162970346,0.818091204,-7887,7887,-0.655120857,0.655120857
Georgia,GA,Upson County,13,293,13293,Falcons,#a71930,26368,3471,7288,10924,0.317740754,0.667154888,-3817,3817,-0.349414134,0.349414134
Georgia,GA,Walker County,13,295,13295,Falcons,#a71930,68066,4213,18938,23939,0.175988972,0.791094031,-14725,14725,-0.615105059,0.615105059
Georgia,GA,Walton County,13,297,13297,Falcons,#a71930,88399,8279,31093,40425,0.204799011,0.769152752,-22814,22814,-0.564353741,0.564353741
Georgia,GA,Ware County,13,299,13299,Falcons,#a71930,35370,3436,8508,12150,0.282798354,0.700246914,-5072,5072,-0.41744856,0.41744856
Georgia,GA,Warren County,13,301,13301,Falcons,#a71930,5460,1313,991,2332,0.563036021,0.424957118,322,-322,0.138078902,-0.138078902
Georgia,GA,Washington County,13,303,13303,Falcons,#a71930,20816,4187,4138,8422,0.497150321,0.491332225,49,-49,0.005818095,-0.005818095
Georgia,GA,Wayne County,13,305,13305,Falcons,#a71930,29534,2039,8147,10376,0.19651118,0.785177332,-6108,6108,-0.588666153,0.588666153
Georgia,GA,Webster County,13,307,13307,Falcons,#a71930,2648,471,630,1114,0.422800718,0.565529623,-159,159,-0.142728905,0.142728905
Georgia,GA,Wheeler County,13,309,13309,Falcons,#a71930,7903,646,1421,2102,0.307326356,0.676022835,-775,775,-0.36869648,0.36869648
Georgia,GA,White County,13,311,13311,Falcons,#a71930,28319,1672,9751,11771,0.142044006,0.82839181,-8079,8079,-0.686347804,0.686347804
Georgia,GA,Whitfield County,13,313,13313,Falcons,#a71930,104216,7925,21514,30362,0.261017061,0.708583097,-13589,13589,-0.447566036,0.447566036
Georgia,GA,Wilcox County,13,315,13315,Falcons,#a71930,8857,852,2096,2973,0.286579213,0.705011773,-1244,1244,-0.41843256,0.41843256
Georgia,GA,Wilkes County,13,317,13317,Falcons,#a71930,9867,1844,2569,4470,0.412527964,0.574720358,-725,725,-0.162192394,0.162192394
Georgia,GA,Wilkinson County,13,319,13319,Falcons,#a71930,9155,1893,2332,4276,0.442703461,0.545369504,-439,439,-0.102666043,0.102666043
Georgia,GA,Worth County,13,321,13321,Falcons,#a71930,20699,2015,6144,8266,0.243769659,0.743285749,-4129,4129,-0.49951609,0.49951609
Hawaii,HI,Hawaii County,15,1,15001,49ers,#aa0000,196428,41258,17500,64865,0.636059508,0.269791105,23758,-23758,0.366268404,-0.366268404
Hawaii,HI,Honolulu County,15,3,15003,49ers,#aa0000,998714,175634,90296,285683,0.614786319,0.31607061,85338,-85338,0.298715709,-0.298715709
Hawaii,HI,Kalawao County,15,5,15005,49ers,#aa0000,164637,33479,13445,51942,0.64454584,0.258846406,20034,-20034,0.385699434,-0.385699434
Hawaii,HI,Kauai County,15,7,15007,49ers,#aa0000,71735,16456,7574,26335,0.624871844,0.287602051,8882,-8882,0.337269793,-0.337269793
Hawaii,HI,Maui County,15,9,15009,49ers,#aa0000,164637,33479,13445,51942,0.64454584,0.258846406,20034,-20034,0.385699434,-0.385699434
Idaho,ID,Ada County,16,1,16001,Seahawks,#69be28,434211,75676,93748,195587,0.386917331,0.47931611,-18072,18072,-0.092398779,0.092398779
Idaho,ID,Adams County,16,3,16003,Seahawks,#69be28,3843,415,1556,2183,0.19010536,0.712780577,-1141,1141,-0.522675218,0.522675218
Idaho,ID,Bannock County,16,5,16005,Broncos,#fb4f14,83744,10342,17180,33405,0.309594372,0.514294267,-6838,6838,-0.204699895,0.204699895
Idaho,ID,Bear Lake County,16,7,16007,Broncos,#fb4f14,5922,255,2203,2928,0.087090164,0.75239071,-1948,1948,-0.665300546,0.665300546
Idaho,ID,Benewah County,16,9,16009,Seahawks,#69be28,9052,780,3101,4192,0.186068702,0.739742366,-2321,2321,-0.553673664,0.553673664
Idaho,ID,Bingham County,16,11,16011,Broncos,#fb4f14,44990,2924,10907,16625,0.175879699,0.65606015,-7983,7983,-0.480180451,0.480180451
Idaho,ID,Blaine County,16,13,16013,Seahawks,#69be28,21592,6416,3340,10723,0.598340017,0.311479996,3076,-3076,0.286860021,-0.286860021
Idaho,ID,Boise County,16,15,16015,Seahawks,#69be28,7058,777,2673,3812,0.20383001,0.701206716,-1896,1896,-0.497376705,0.497376705
Idaho,ID,Bonner County,16,17,16017,Seahawks,#69be28,41859,5140,10220,16815,0.305679453,0.607790663,-5080,5080,-0.30211121,0.30211121
Idaho,ID,Bonneville County,16,19,16019,Broncos,#fb4f14,110089,8930,26699,44212,0.201981363,0.603885823,-17769,17769,-0.40190446,0.40190446
Idaho,ID,Boundary County,16,21,16021,Seahawks,#69be28,11318,933,3789,5150,0.181165049,0.735728155,-2856,2856,-0.554563107,0.554563107
Idaho,ID,Butte County,16,23,16023,Packers,#203731,2501,160,914,1230,0.130081301,0.743089431,-754,754,-0.61300813,0.61300813
Idaho,ID,Camas County,16,25,16025,Seahawks,#69be28,1066,110,410,599,0.183639399,0.684474124,-300,300,-0.500834725,0.500834725
Idaho,ID,Canyon County,16,27,16027,Cowboys,#002244,207478,16683,46755,72007,0.231685808,0.649311872,-30072,30072,-0.417626064,0.417626064
Idaho,ID,Caribou County,16,29,16029,Broncos,#fb4f14,6770,271,2275,3035,0.089291598,0.749588138,-2004,2004,-0.66029654,0.66029654
Idaho,ID,Cassia County,16,31,16031,Cowboys,#002244,23506,1036,5949,8178,0.12668134,0.727439472,-4913,4913,-0.600758132,0.600758132
Idaho,ID,Clark County,16,33,16033,Broncos,#fb4f14,880,44,203,283,0.155477032,0.717314488,-159,159,-0.561837456,0.561837456
Idaho,ID,Clearwater County,16,35,16035,Seahawks,#69be28,8496,704,2852,3801,0.185214417,0.750328861,-2148,2148,-0.565114444,0.565114444
Idaho,ID,Custer County,16,37,16037,Seahawks,#69be28,4087,427,1777,2413,0.176958143,0.736427683,-1350,1350,-0.55946954,0.55946954
Idaho,ID,Elmore County,16,39,16039,Seahawks,#69be28,25876,1814,5816,8519,0.212935791,0.682709238,-4002,4002,-0.469773448,0.469773448
Idaho,ID,Franklin County,16,41,16041,Broncos,#fb4f14,13074,385,3901,5499,0.07001273,0.709401709,-3516,3516,-0.63938898,0.63938898
Idaho,ID,Fremont County,16,43,16043,Broncos,#fb4f14,12819,651,4091,5714,0.113930697,0.715960798,-3440,3440,-0.602030102,0.602030102
Idaho,ID,Gem County,16,45,16045,Seahawks,#69be28,16852,1229,5980,7952,0.154552314,0.752012072,-4751,4751,-0.597459759,0.597459759
Idaho,ID,Gooding County,16,47,16047,Seahawks,#69be28,15284,930,3743,5191,0.179156232,0.721055673,-2813,2813,-0.541899441,0.541899441
Idaho,ID,Idaho County,16,49,16049,Seahawks,#69be28,16272,1196,6441,8223,0.145445701,0.78329077,-5245,5245,-0.637845069,0.637845069
Idaho,ID,Jefferson County,16,51,16051,Broncos,#fb4f14,27157,976,8436,11471,0.085084125,0.735419754,-7460,7460,-0.650335629,0.650335629
Idaho,ID,Jerome County,16,53,16053,Cowboys,#002244,22814,2117,7347,10667,0.198462548,0.688759726,-5230,5230,-0.490297178,0.490297178
Idaho,ID,Kootenai County,16,55,16055,Seahawks,#69be28,150346,16264,44449,66286,0.245361011,0.67056392,-28185,28185,-0.425202909,0.425202909
Idaho,ID,Latah County,16,57,16057,Seahawks,#69be28,38778,8093,7255,18146,0.445993607,0.399812631,838,-838,0.046180977,-0.046180977
Idaho,ID,Lemhi County,16,59,16059,Broncos,#fb4f14,7735,733,3011,4068,0.180186824,0.740167158,-2278,2278,-0.559980334,0.559980334
Idaho,ID,Lewis County,16,61,16061,Seahawks,#69be28,3789,270,1202,1590,0.169811321,0.755974843,-932,932,-0.586163522,0.586163522
Idaho,ID,Lincoln County,16,63,16063,Broncos,#fb4f14,5297,360,1184,1748,0.205949657,0.677345538,-824,824,-0.471395881,0.471395881
Idaho,ID,Madison County,16,65,16065,Broncos,#fb4f14,38273,1201,8941,15687,0.076560209,0.569962389,-7740,7740,-0.49340218,0.49340218
Idaho,ID,Minidoka County,16,67,16067,Cowboys,#002244,20461,1167,4887,6870,0.169868996,0.711353712,-3720,3720,-0.541484716,0.541484716
Idaho,ID,Nez Perce County,16,69,16069,Seahawks,#69be28,40048,4828,10699,17195,0.280779296,0.62221576,-5871,5871,-0.341436464,0.341436464
Idaho,ID,Oneida County,16,71,16071,Broncos,#fb4f14,4281,184,1531,2068,0.088974855,0.74032882,-1347,1347,-0.651353965,0.651353965
Idaho,ID,Owyhee County,16,73,16073,Cowboys,#002244,11310,591,3052,3920,0.150765306,0.778571429,-2461,2461,-0.627806122,0.627806122
Idaho,ID,Payette County,16,75,16075,Seahawks,#69be28,22896,892,4306,5703,0.156408908,0.755041206,-3414,3414,-0.598632299,0.598632299
Idaho,ID,Power County,16,77,16077,Cowboys,#002244,7648,699,1666,2758,0.253444525,0.604060914,-967,967,-0.350616389,0.350616389
Idaho,ID,Shoshone County,16,79,16079,Seahawks,#69be28,12432,1384,3297,5120,0.2703125,0.643945313,-1913,1913,-0.373632813,0.373632813
Idaho,ID,Teton County,16,81,16081,Broncos,#fb4f14,10564,2157,2161,4966,0.434353605,0.435159082,-4,4,-0.000805477,0.000805477
Idaho,ID,Twin Falls County,16,83,16083,Broncos,#fb4f14,82375,6844,21063,31893,0.214592544,0.660427053,-14219,14219,-0.445834509,0.445834509
Idaho,ID,Valley County,16,85,16085,Seahawks,#69be28,10103,1913,2906,5349,0.357636941,0.543279118,-993,993,-0.185642176,0.185642176
Idaho,ID,Washington County,16,87,16087,Seahawks,#69be28,9984,776,3283,4454,0.174225415,0.737090256,-2507,2507,-0.562864841,0.562864841
Illinois,IL,Adams County,17,1,17001,Bears,#c83803,67013,7633,22732,31770,0.240258105,0.715517784,-15099,15099,-0.475259679,0.475259679
Illinois,IL,Alexander County,17,3,17003,Bears,#c83803,6780,1262,1496,2820,0.44751773,0.530496454,-234,234,-0.082978723,0.082978723
Illinois,IL,Bond County,17,5,17005,Rams,#b3995d,16950,2066,4884,7462,0.276869472,0.654516215,-2818,2818,-0.377646744,0.377646744
Illinois,IL,Boone County,17,7,17007,Bears,#c83803,53585,8952,12261,22604,0.3960361,0.542426119,-3309,3309,-0.146390019,0.146390019
Illinois,IL,Brown County,17,9,17009,Bears,#c83803,6829,475,1776,2336,0.203339041,0.760273973,-1301,1301,-0.556934932,0.556934932
Illinois,IL,Bureau County,17,11,17011,Bears,#c83803,33587,6010,9264,16303,0.368643808,0.568238974,-3254,3254,-0.199595167,0.199595167
Illinois,IL,Calhoun County,17,13,17013,Rams,#b3995d,4899,739,1719,2556,0.289123631,0.672535211,-980,980,-0.383411581,0.383411581
Illinois,IL,Carroll County,17,15,17015,Bears,#c83803,14616,2437,4428,7354,0.331384281,0.602121295,-1991,1991,-0.270737014,0.270737014
Illinois,IL,Cass County,17,17,17017,Bears,#c83803,12847,1617,3216,5054,0.319944598,0.636327661,-1599,1599,-0.316383063,0.316383063
Illinois,IL,Champaign County,17,19,17019,Bears,#c83803,208861,49694,33235,89196,0.557132607,0.372606395,16459,-16459,0.184526212,-0.184526212
Illinois,IL,Christian County,17,21,17021,Bears,#c83803,33642,3982,10522,15310,0.260091444,0.687263227,-6540,6540,-0.427171783,0.427171783
Illinois,IL,Clark County,17,23,17023,Bears,#c83803,15979,1873,5620,7819,0.239544699,0.71876199,-3747,3747,-0.479217291,0.479217291
Illinois,IL,Clay County,17,25,17025,Bears,#c83803,13428,1014,5009,6278,0.161516406,0.797865562,-3995,3995,-0.636349156,0.636349156
Illinois,IL,Clinton County,17,27,17027,Rams,#b3995d,37786,3939,12394,17268,0.228109798,0.717743804,-8455,8455,-0.489634005,0.489634005
Illinois,IL,Coles County,17,29,17029,Bears,#c83803,52521,7285,12985,21580,0.337581094,0.601714551,-5700,5700,-0.264133457,0.264133457
Illinois,IL,Cook County,17,31,17031,Bears,#c83803,5238216,1528582,440213,2055215,0.743757709,0.214193162,1088369,-1088369,0.529564547,-0.529564547
Illinois,IL,Crawford County,17,33,17033,Bears,#c83803,19414,1969,6146,8507,0.231456448,0.722463853,-4177,4177,-0.491007406,0.491007406
Illinois,IL,Cumberland County,17,35,17035,Bears,#c83803,10898,1028,4200,5513,0.186468348,0.761835661,-3172,3172,-0.575367314,0.575367314
Illinois,IL,DeKalb County,17,37,17037,Bears,#c83803,104352,20348,19051,42605,0.477596526,0.44715409,1297,-1297,0.030442436,-0.030442436
Illinois,IL,De Witt County,17,39,17039,Bears,#c83803,16247,1907,5072,7469,0.255321998,0.679073504,-3165,3165,-0.423751506,0.423751506
Illinois,IL,Douglas County,17,41,17041,Bears,#c83803,19823,1946,5695,8089,0.240573618,0.704042527,-3749,3749,-0.463468908,0.463468908
Illinois,IL,DuPage County,17,43,17043,Bears,#c83803,933736,222499,164355,412929,0.538831131,0.39802242,58144,-58144,0.14080871,-0.14080871
Illinois,IL,Edgar County,17,45,17045,Bears,#c83803,17664,1778,5634,7783,0.228446614,0.723885391,-3856,3856,-0.495438777,0.495438777
Illinois,IL,Edwards County,17,47,17047,Bears,#c83803,6534,432,2777,3312,0.130434783,0.838466184,-2345,2345,-0.708031401,0.708031401
Illinois,IL,Effingham County,17,49,17049,Bears,#c83803,34371,3071,13613,17428,0.176210695,0.78109938,-10542,10542,-0.604888685,0.604888685
Illinois,IL,Fayette County,17,51,17051,Bears,#c83803,22043,1814,7363,9515,0.190646348,0.773830793,-5549,5549,-0.583184446,0.583184446
Illinois,IL,Ford County,17,53,17053,Bears,#c83803,13736,1410,4474,6289,0.224200986,0.711400859,-3064,3064,-0.487199873,0.487199873
Illinois,IL,Franklin County,17,55,17055,Bears,#c83803,39485,4711,13101,18533,0.254195219,0.706901203,-8390,8390,-0.452705984,0.452705984
Illinois,IL,Fulton County,17,57,17057,Bears,#c83803,35699,6118,8482,15609,0.39195336,0.543404446,-2364,2364,-0.151451086,0.151451086
Illinois,IL,Gallatin County,17,59,17059,Bears,#c83803,5265,656,1942,2691,0.243775548,0.721664809,-1286,1286,-0.47788926,0.47788926
Illinois,IL,Greene County,17,61,17061,Bears,#c83803,13241,1202,4139,5542,0.21688921,0.746842295,-2937,2937,-0.529953086,0.529953086
Illinois,IL,Grundy County,17,63,17063,Bears,#c83803,50541,8021,13417,22891,0.35039972,0.586125552,-5396,5396,-0.235725831,0.235725831
Illinois,IL,Hamilton County,17,65,17065,Bears,#c83803,8200,800,3205,4143,0.19309679,0.773594014,-2405,2405,-0.580497224,0.580497224
Illinois,IL,Hancock County,17,67,17067,Bears,#c83803,18543,1744,5713,7818,0.223074955,0.730749552,-3969,3969,-0.507674597,0.507674597
Illinois,IL,Hardin County,17,69,17069,Bears,#c83803,4135,419,1650,2133,0.196436943,0.773558368,-1231,1231,-0.577121425,0.577121425
Illinois,IL,Henderson County,17,71,17071,Bears,#c83803,6995,1151,2153,3480,0.330747126,0.618678161,-1002,1002,-0.287931034,0.287931034
Illinois,IL,Henry County,17,73,17073,Bears,#c83803,49489,8835,13962,24232,0.364600528,0.576180258,-5127,5127,-0.211579729,0.211579729
Illinois,IL,Iroquois County,17,75,17075,Bears,#c83803,28672,2496,9728,12923,0.193144007,0.752766386,-7232,7232,-0.559622379,0.559622379
Illinois,IL,Jackson County,17,77,17077,Bears,#c83803,59362,11619,10889,24509,0.47407075,0.444285773,730,-730,0.029784977,-0.029784977
Illinois,IL,Jasper County,17,79,17079,Bears,#c83803,9607,924,3973,5104,0.181034483,0.778409091,-3049,3049,-0.597374608,0.597374608
Illinois,IL,Jefferson County,17,81,17081,Bears,#c83803,38353,4408,11681,16818,0.262100131,0.694553455,-7273,7273,-0.432453324,0.432453324
Illinois,IL,Jersey County,17,83,17083,Rams,#b3995d,22372,2673,7737,10909,0.245027042,0.70923091,-5064,5064,-0.464203868,0.464203868
Illinois,IL,Jo Daviess County,17,85,17085,Bears,#c83803,22086,4452,6113,11177,0.398317974,0.546926725,-1661,1661,-0.14860875,0.14860875
Illinois,IL,Johnson County,17,87,17087,Bears,#c83803,12762,1135,4644,6017,0.188632209,0.771813196,-3509,3509,-0.583180987,0.583180987
Illinois,IL,Kane County,17,89,17089,Bears,#c83803,530847,99389,82087,193500,0.513638243,0.424222222,17302,-17302,0.089416021,-0.089416021
Illinois,IL,Kankakee County,17,91,17091,Bears,#c83803,110879,18908,25081,46556,0.406134548,0.538727554,-6173,6173,-0.132593006,0.132593006
Illinois,IL,Kendall County,17,93,17093,Bears,#c83803,123355,23392,24152,50815,0.460336515,0.475292729,-760,760,-0.014956214,0.014956214
Illinois,IL,Knox County,17,95,17095,Bears,#c83803,51441,9939,10658,21964,0.452513203,0.485248589,-719,719,-0.032735385,0.032735385
Illinois,IL,Lake County,17,97,17097,Bears,#c83803,703910,168186,108608,293574,0.572891332,0.369951017,59578,-59578,0.202940315,-0.202940315
Illinois,IL,LaSalle County,17,99,17099,Bears,#c83803,111333,19277,26269,48447,0.397898735,0.542221397,-6992,6992,-0.144322662,0.144322662
Illinois,IL,Lawrence County,17,101,17101,Bears,#c83803,16491,1288,4517,6039,0.213280344,0.747971518,-3229,3229,-0.534691174,0.534691174
Illinois,IL,Lee County,17,103,17103,Bears,#c83803,34584,5499,8597,15215,0.361419652,0.565034505,-3098,3098,-0.203614854,0.203614854
Illinois,IL,Livingston County,17,105,17105,Bears,#c83803,36671,4005,10197,15096,0.265302067,0.675476948,-6192,6192,-0.410174881,0.410174881
Illinois,IL,Logan County,17,107,17107,Bears,#c83803,29494,3301,8167,12130,0.272135202,0.673289365,-4866,4866,-0.401154163,0.401154163
Illinois,IL,McDonough County,17,109,17109,Bears,#c83803,31333,5278,6789,12910,0.408830364,0.525871418,-1511,1511,-0.117041053,0.117041053
Illinois,IL,McHenry County,17,111,17111,Bears,#c83803,307343,59827,71117,140145,0.426893575,0.507452995,-11290,11290,-0.080559421,0.080559421
Illinois,IL,McLean County,17,113,17113,Bears,#c83803,173166,35918,37081,78995,0.454687006,0.469409456,-1163,1163,-0.014722451,0.014722451
Illinois,IL,Macon County,17,115,17115,Bears,#c83803,107303,18211,26782,47283,0.385148996,0.56641922,-8571,8571,-0.181270224,0.181270224
Illinois,IL,Macoupin County,17,117,17117,Bears,#c83803,46045,6532,14194,21881,0.298523833,0.648690645,-7662,7662,-0.350166811,0.350166811
Illinois,IL,Madison County,17,119,17119,Rams,#b3995d,266209,50336,70295,127902,0.393551313,0.549600475,-19959,19959,-0.156049163,0.156049163
Illinois,IL,Marion County,17,121,17121,Bears,#c83803,38339,4231,11677,16600,0.254879518,0.703433735,-7446,7446,-0.448554217,0.448554217
Illinois,IL,Marshall County,17,123,17123,Bears,#c83803,11982,1784,3776,5903,0.302219211,0.639674742,-1992,1992,-0.337455531,0.337455531
Illinois,IL,Mason County,17,125,17125,Bears,#c83803,13701,2008,4051,6433,0.312140525,0.629721747,-2043,2043,-0.317581222,0.317581222
Illinois,IL,Massac County,17,127,17127,Bears,#c83803,14766,1555,4844,6633,0.234433891,0.730287954,-3289,3289,-0.495854063,0.495854063
Illinois,IL,Menard County,17,129,17129,Bears,#c83803,12444,1808,4230,6423,0.281488401,0.658570761,-2422,2422,-0.37708236,0.37708236
Illinois,IL,Mercer County,17,131,17131,Bears,#c83803,15858,3061,4800,8417,0.363668766,0.570274445,-1739,1739,-0.206605679,0.206605679
Illinois,IL,Monroe County,17,133,17133,Rams,#b3995d,33879,5522,12614,19074,0.289504037,0.661319073,-7092,7092,-0.371815036,0.371815036
Illinois,IL,Montgomery County,17,135,17135,Bears,#c83803,28898,3490,8616,12829,0.27203991,0.671603399,-5126,5126,-0.399563489,0.399563489
Illinois,IL,Morgan County,17,137,17137,Bears,#c83803,34828,4693,9060,14607,0.321284316,0.620250565,-4367,4367,-0.298966249,0.298966249
Illinois,IL,Moultrie County,17,139,17139,Bears,#c83803,14931,1476,4453,6209,0.23771944,0.717184732,-2977,2977,-0.479465292,0.479465292
Illinois,IL,Ogle County,17,141,17141,Bears,#c83803,51659,8025,14344,23798,0.337213211,0.602739726,-6319,6319,-0.265526515,0.265526515
Illinois,IL,Peoria County,17,143,17143,Bears,#c83803,186221,37436,35299,77465,0.483263409,0.455676757,2137,-2137,0.027586652,-0.027586652
Illinois,IL,Perry County,17,145,17145,Bears,#c83803,21543,2433,6816,9706,0.250669689,0.702246033,-4383,4383,-0.451576345,0.451576345
Illinois,IL,Piatt County,17,147,17147,Bears,#c83803,16387,2633,5623,8899,0.295875941,0.631868749,-2990,2990,-0.335992808,0.335992808
Illinois,IL,Pike County,17,149,17149,Bears,#c83803,15989,1412,5749,7458,0.189326897,0.770850094,-4337,4337,-0.581523197,0.581523197
Illinois,IL,Pope County,17,151,17151,Bears,#c83803,4226,374,1678,2132,0.175422139,0.787054409,-1304,1304,-0.61163227,0.61163227
Illinois,IL,Pulaski County,17,153,17153,Bears,#c83803,5678,817,1583,2473,0.330367974,0.640113223,-766,766,-0.309745249,0.309745249
Illinois,IL,Putnam County,17,155,17155,Bears,#c83803,5644,1143,1762,3076,0.371586476,0.572821847,-619,619,-0.201235371,0.201235371
Illinois,IL,Randolph County,17,157,17157,Rams,#b3995d,32852,3421,9992,14032,0.243799886,0.712086659,-6571,6571,-0.468286773,0.468286773
Illinois,IL,Richland County,17,159,17159,Bears,#c83803,16029,1579,5736,7630,0.206946265,0.751769332,-4157,4157,-0.544823067,0.544823067
Illinois,IL,Rock Island County,17,161,17161,Bears,#c83803,146133,32258,26969,62971,0.512267552,0.428276508,5289,-5289,0.083991043,-0.083991043
Illinois,IL,St. Clair County,17,163,17163,Rams,#b3995d,264052,60180,53479,119201,0.504861536,0.448645565,6701,-6701,0.056215971,-0.056215971
Illinois,IL,Saline County,17,165,17165,Bears,#c83803,24548,2551,8248,11234,0.227078512,0.734199751,-5697,5697,-0.507121239,0.507121239
Illinois,IL,Sangamon County,17,167,17167,Bears,#c83803,198712,40731,49823,96472,0.422205407,0.516450369,-9092,9092,-0.094244962,0.094244962
Illinois,IL,Schuyler County,17,169,17169,Bears,#c83803,7032,1074,2523,3792,0.283227848,0.665348101,-1449,1449,-0.382120253,0.382120253
Illinois,IL,Scott County,17,171,17171,Bears,#c83803,5092,528,1965,2583,0.204413473,0.760743322,-1437,1437,-0.556329849,0.556329849
Illinois,IL,Shelby County,17,173,17173,Bears,#c83803,21775,2279,8209,10912,0.208852639,0.752291056,-5930,5930,-0.543438416,0.543438416
Illinois,IL,Stark County,17,175,17175,Bears,#c83803,5788,748,1777,2707,0.27632065,0.65644625,-1029,1029,-0.3801256,0.3801256
Illinois,IL,Stephenson County,17,177,17177,Bears,#c83803,45749,7531,10845,19525,0.385710627,0.555441741,-3314,3314,-0.169731114,0.169731114
Illinois,IL,Tazewell County,17,179,17179,Bears,#c83803,134800,20568,38620,63347,0.324687831,0.609657916,-18052,18052,-0.284970085,0.284970085
Illinois,IL,Union County,17,181,17181,Bears,#c83803,17408,2389,5780,8514,0.280596664,0.678881842,-3391,3391,-0.398285177,0.398285177
Illinois,IL,Vermilion County,17,183,17183,Bears,#c83803,79282,9876,18582,29799,0.331420517,0.623577972,-8706,8706,-0.292157455,0.292157455
Illinois,IL,Wabash County,17,185,17185,Bears,#c83803,11542,1146,4039,5402,0.21214365,0.747686042,-2893,2893,-0.535542392,0.535542392
Illinois,IL,Warren County,17,187,17187,Bears,#c83803,17527,2983,4267,7700,0.387402597,0.554155844,-1284,1284,-0.166753247,0.166753247
Illinois,IL,Washington County,17,189,17189,Rams,#b3995d,14270,1446,5566,7376,0.196041215,0.754609544,-4120,4120,-0.55856833,0.55856833
Illinois,IL,Wayne County,17,191,17191,Bears,#c83803,16423,1048,6963,8256,0.126937984,0.843386628,-5915,5915,-0.716448643,0.716448643
Illinois,IL,White County,17,193,17193,Bears,#c83803,14327,1412,5639,7289,0.193716559,0.7736315,-4227,4227,-0.57991494,0.57991494
Illinois,IL,Whiteside County,17,195,17195,Bears,#c83803,57079,11005,12597,25210,0.436533122,0.499682666,-1592,1592,-0.063149544,0.063149544
Illinois,IL,Will County,17,197,17197,Bears,#c83803,687263,146230,129726,291010,0.502491323,0.445778496,16504,-16504,0.056712828,-0.056712828
Illinois,IL,Williamson County,17,199,17199,Bears,#c83803,67466,8539,21503,31422,0.271752275,0.684329451,-12964,12964,-0.412577175,0.412577175
Illinois,IL,Winnebago County,17,201,17201,Bears,#c83803,287078,52595,53922,113027,0.465331293,0.47707185,-1327,1327,-0.011740558,0.011740558
Illinois,IL,Woodford County,17,203,17203,Bears,#c83803,39227,5068,13180,19389,0.261385322,0.679766878,-8112,8112,-0.418381557,0.418381557
Indiana,IN,Adams County,18,1,18001,Colts,#002c5f,34980,2802,9642,13039,0.21489378,0.739473886,-6840,6840,-0.524580106,0.524580106
Indiana,IN,Allen County,18,3,18003,Colts,#002c5f,368450,55222,83801,145787,0.378785488,0.574818056,-28579,28579,-0.196032568,0.196032568
Indiana,IN,Bartholomew County,18,5,18005,Colts,#002c5f,81162,9841,20637,32389,0.303837723,0.637160764,-10796,10796,-0.333323042,0.333323042
Indiana,IN,Benton County,18,7,18007,Colts,#002c5f,8681,860,2579,3654,0.235358511,0.705801861,-1719,1719,-0.47044335,0.47044335
Indiana,IN,Blackford County,18,9,18009,Colts,#002c5f,12298,1243,3349,4822,0.257776856,0.694525093,-2106,2106,-0.436748237,0.436748237
Indiana,IN,Boone County,18,11,18011,Colts,#002c5f,63344,10181,19654,32061,0.317550919,0.613018933,-9473,9473,-0.295468014,0.295468014
Indiana,IN,Brown County,18,13,18013,Colts,#002c5f,14977,2518,5015,7908,0.318411735,0.634167931,-2497,2497,-0.315756196,0.315756196
Indiana,IN,Carroll County,18,15,18015,Colts,#002c5f,19856,1891,6273,8609,0.219653851,0.728656058,-4382,4382,-0.509002207,0.509002207
Indiana,IN,Cass County,18,17,18017,Colts,#002c5f,37979,3758,9697,14135,0.265864874,0.686027591,-5939,5939,-0.420162717,0.420162717
Indiana,IN,Clark County,18,19,18019,Colts,#002c5f,115371,18791,30012,51104,0.367701158,0.587273012,-11221,11221,-0.219571853,0.219571853
Indiana,IN,Clay County,18,21,18021,Colts,#002c5f,26503,2306,8528,11259,0.204813927,0.757438494,-6222,6222,-0.552624567,0.552624567
Indiana,IN,Clinton County,18,23,18023,Colts,#002c5f,32609,2819,8530,11896,0.23697041,0.717047747,-5711,5711,-0.480077337,0.480077337
Indiana,IN,Crawford County,18,25,18025,Colts,#002c5f,10483,1323,3013,4591,0.288172511,0.656284034,-1690,1690,-0.368111523,0.368111523
Indiana,IN,Daviess County,18,27,18027,Colts,#002c5f,32906,1800,8545,10736,0.167660209,0.795920268,-6745,6745,-0.62826006,0.62826006
Indiana,IN,Dearborn County,18,29,18029,Bengals,#fb4f14,49455,4883,18110,23910,0.204224174,0.757423672,-13227,13227,-0.553199498,0.553199498
Indiana,IN,Decatur County,18,31,18031,Colts,#002c5f,26521,2121,8488,11095,0.191167192,0.765029292,-6367,6367,-0.5738621,0.5738621
Indiana,IN,DeKalb County,18,33,18033,Colts,#002c5f,42589,3941,12054,16816,0.234360133,0.716817317,-8113,8113,-0.482457184,0.482457184
Indiana,IN,Delaware County,18,35,18035,Colts,#002c5f,116852,18100,24217,44699,0.404930759,0.541779458,-6117,6117,-0.136848699,0.136848699
Indiana,IN,Dubois County,18,37,18037,Colts,#002c5f,42461,5389,13365,19917,0.270572877,0.671034794,-7976,7976,-0.400461917,0.400461917
Indiana,IN,Elkhart County,18,39,18039,Colts,#002c5f,203474,20667,41810,65187,0.317041741,0.641385552,-21143,21143,-0.324343811,0.324343811
Indiana,IN,Fayette County,18,41,18041,Colts,#002c5f,23434,2252,6839,9530,0.236306401,0.717628541,-4587,4587,-0.481322141,0.481322141
Indiana,IN,Floyd County,18,43,18043,Colts,#002c5f,76778,13939,21427,37225,0.374452653,0.57560779,-7488,7488,-0.201155138,0.201155138
Indiana,IN,Fountain County,18,45,18045,Colts,#002c5f,16591,1476,5661,7474,0.197484613,0.757425743,-4185,4185,-0.559941129,0.559941129
Indiana,IN,Franklin County,18,47,18047,Bengals,#fb4f14,22872,1967,8665,10990,0.178980892,0.78844404,-6698,6698,-0.609463148,0.609463148
Indiana,IN,Fulton County,18,49,18049,Colts,#002c5f,20315,1960,6010,8374,0.234057798,0.717697636,-4050,4050,-0.483639838,0.483639838
Indiana,IN,Gibson County,18,51,18051,Colts,#002c5f,33775,3720,11079,15472,0.240434333,0.716067735,-7359,7359,-0.475633402,0.475633402
Indiana,IN,Grant County,18,53,18053,Colts,#002c5f,67979,7029,17009,25239,0.278497563,0.67391735,-9980,9980,-0.395419787,0.395419787
Indiana,IN,Greene County,18,55,18055,Colts,#002c5f,32441,2929,10275,13763,0.212816973,0.746566882,-7346,7346,-0.533749909,0.533749909
Indiana,IN,Hamilton County,18,57,18057,Colts,#002c5f,309697,57214,87299,153630,0.372414242,0.56824188,-30085,30085,-0.195827638,0.195827638
Indiana,IN,Hancock County,18,59,18059,Colts,#002c5f,72520,8901,25050,36027,0.247064701,0.695311849,-16149,16149,-0.448247148,0.448247148
Indiana,IN,Harrison County,18,61,18061,Colts,#002c5f,39578,4776,12993,18528,0.257772021,0.701262953,-8217,8217,-0.443490933,0.443490933
Indiana,IN,Hendricks County,18,63,18063,Colts,#002c5f,158192,22595,48326,75258,0.300233862,0.642137713,-25731,25731,-0.341903851,0.341903851
Indiana,IN,Henry County,18,65,18065,Colts,#002c5f,48985,5124,13895,20075,0.255242839,0.692154421,-8771,8771,-0.436911582,0.436911582
Indiana,IN,Howard County,18,67,18067,Colts,#002c5f,82556,11215,23675,36754,0.305136856,0.644147576,-12460,12460,-0.33901072,0.33901072
Indiana,IN,Huntington County,18,69,18069,Colts,#002c5f,36630,3506,11649,15974,0.219481658,0.729247527,-8143,8143,-0.50976587,0.50976587
Indiana,IN,Jackson County,18,71,18071,Colts,#002c5f,44069,3843,12857,17532,0.219199179,0.733344741,-9014,9014,-0.514145562,0.514145562
Indiana,IN,Jasper County,18,73,18073,Bears,#c83803,33470,3329,9382,13331,0.249718701,0.70377316,-6053,6053,-0.45405446,0.45405446
Indiana,IN,Jay County,18,75,18075,Colts,#002c5f,21121,1889,5697,7962,0.237251947,0.715523738,-3808,3808,-0.478271791,0.478271791
Indiana,IN,Jefferson County,18,77,18077,Bengals,#fb4f14,32416,4325,8538,13461,0.321298566,0.6342768,-4213,4213,-0.312978233,0.312978233
Indiana,IN,Jennings County,18,79,18079,Colts,#002c5f,27897,2364,8222,11115,0.21268556,0.739721098,-5858,5858,-0.527035538,0.527035538
Indiana,IN,Johnson County,18,81,18081,Colts,#002c5f,149633,17318,45456,66229,0.26148666,0.686345861,-28138,28138,-0.424859201,0.424859201
Indiana,IN,Knox County,18,83,18083,Colts,#002c5f,37927,3772,11077,15483,0.243622037,0.715429826,-7305,7305,-0.471807789,0.471807789
Indiana,IN,Kosciusko County,18,85,18085,Colts,#002c5f,78620,6311,23909,31907,0.197793588,0.749334002,-17598,17598,-0.551540414,0.551540414
Indiana,IN,LaGrange County,18,87,18087,Colts,#002c5f,38809,2080,7025,9552,0.217755444,0.735448074,-4945,4945,-0.51769263,0.51769263
Indiana,IN,Lake County,18,89,18089,Bears,#c83803,487865,116896,75565,200247,0.583759058,0.377358962,41331,-41331,0.206400096,-0.206400096
Indiana,IN,LaPorte County,18,91,18091,Bears,#c83803,110884,19795,22678,44994,0.439947549,0.504022759,-2883,2883,-0.06407521,0.06407521
Indiana,IN,Lawrence County,18,93,18093,Colts,#002c5f,45495,4210,14034,19076,0.220696163,0.735688824,-9824,9824,-0.514992661,0.514992661
Indiana,IN,Madison County,18,95,18095,Colts,#002c5f,129723,18595,32376,53660,0.346533731,0.603354454,-13781,13781,-0.256820723,0.256820723
Indiana,IN,Marion County,18,97,18097,Colts,#002c5f,939020,212676,130228,361070,0.58901598,0.360672446,82448,-82448,0.228343534,-0.228343534
Indiana,IN,Marshall County,18,99,18099,Colts,#002c5f,46857,4798,12286,18008,0.266437139,0.682252332,-7488,7488,-0.415815193,0.415815193
Indiana,IN,Martin County,18,101,18101,Colts,#002c5f,10226,881,3695,4807,0.183274392,0.768670689,-2814,2814,-0.585396297,0.585396297
Indiana,IN,Miami County,18,103,18103,Colts,#002c5f,35862,2766,9975,13440,0.205803571,0.7421875,-7209,7209,-0.536383929,0.536383929
Indiana,IN,Monroe County,18,105,18105,Colts,#002c5f,144705,34183,20527,57623,0.593217986,0.356229283,13656,-13656,0.236988702,-0.236988702
Indiana,IN,Montgomery County,18,107,18107,Colts,#002c5f,38227,3362,11051,15101,0.222634263,0.731805841,-7689,7689,-0.509171578,0.509171578
Indiana,IN,Morgan County,18,109,18109,Colts,#002c5f,69648,6037,23671,31180,0.193617704,0.759172547,-17634,17634,-0.565554843,0.565554843
Indiana,IN,Newton County,18,111,18111,Bears,#c83803,14008,1403,4074,5791,0.242272492,0.703505439,-2671,2671,-0.461232948,0.461232948
Indiana,IN,Noble County,18,113,18113,Colts,#002c5f,47733,3904,12198,16890,0.231142688,0.722202487,-8294,8294,-0.491059799,0.491059799
Indiana,IN,Ohio County,18,115,18115,Bengals,#fb4f14,5938,686,2118,2917,0.235173123,0.726088447,-1432,1432,-0.490915324,0.490915324
Indiana,IN,Orange County,18,117,18117,Colts,#002c5f,19605,2048,5800,8189,0.250091586,0.708267188,-3752,3752,-0.458175601,0.458175601
Indiana,IN,Owen County,18,119,18119,Colts,#002c5f,20872,1946,6151,8520,0.228403756,0.721948357,-4205,4205,-0.493544601,0.493544601
Indiana,IN,Parke County,18,121,18121,Colts,#002c5f,16901,1441,4863,6576,0.21913017,0.739507299,-3422,3422,-0.520377129,0.520377129
Indiana,IN,Perry County,18,123,18123,Colts,#002c5f,19347,3062,4556,8025,0.381557632,0.567725857,-1494,1494,-0.186168224,0.186168224
Indiana,IN,Pike County,18,125,18125,Colts,#002c5f,12594,1297,4398,5977,0.216998494,0.735820646,-3101,3101,-0.518822152,0.518822152
Indiana,IN,Porter County,18,127,18127,Bears,#c83803,167688,33531,38719,76492,0.438359567,0.506183653,-5188,5188,-0.067824086,0.067824086
Indiana,IN,Posey County,18,129,18129,Colts,#002c5f,25512,3515,8393,12448,0.282374679,0.674244859,-4878,4878,-0.39187018,0.39187018
Indiana,IN,Pulaski County,18,131,18131,Colts,#002c5f,12889,1327,3854,5437,0.24406842,0.708846791,-2527,2527,-0.46477837,0.46477837
Indiana,IN,Putnam County,18,133,18133,Colts,#002c5f,37585,3356,10637,14680,0.228610354,0.724591281,-7281,7281,-0.495980926,0.495980926
Indiana,IN,Randolph County,18,135,18135,Colts,#002c5f,25172,2446,7515,10456,0.23393267,0.71872609,-5069,5069,-0.48479342,0.48479342
Indiana,IN,Ripley County,18,137,18137,Bengals,#fb4f14,28701,2471,9806,12790,0.193197811,0.766692729,-7335,7335,-0.573494918,0.573494918
Indiana,IN,Rush County,18,139,18139,Colts,#002c5f,16672,1525,5292,7214,0.211394511,0.733573607,-3767,3767,-0.522179096,0.522179096
Indiana,IN,St. Joseph County,18,141,18141,Bears,#c83803,268441,52247,52019,109452,0.477350802,0.475267697,228,-228,0.002083105,-0.002083105
Indiana,IN,Scott County,18,143,18143,Colts,#002c5f,23744,2642,6074,9060,0.291611479,0.670419426,-3432,3432,-0.378807947,0.378807947
Indiana,IN,Shelby County,18,145,18145,Colts,#002c5f,44478,4247,12718,17935,0.236799554,0.709116253,-8471,8471,-0.472316699,0.472316699
Indiana,IN,Spencer County,18,147,18147,Colts,#002c5f,20715,2861,6572,9959,0.287277839,0.659905613,-3711,3711,-0.372627774,0.372627774
Indiana,IN,Starke County,18,149,18149,Bears,#c83803,22958,2489,6367,9226,0.269781054,0.690114893,-3878,3878,-0.420333839,0.420333839
Indiana,IN,Steuben County,18,151,18151,Colts,#002c5f,34372,3741,10127,14530,0.257467309,0.696971783,-6386,6386,-0.439504474,0.439504474
Indiana,IN,Sullivan County,18,153,18153,Colts,#002c5f,20928,2113,6138,8559,0.246874635,0.717139853,-4025,4025,-0.470265218,0.470265218
Indiana,IN,Switzerland County,18,155,18155,Bengals,#fb4f14,10524,930,2558,3639,0.255564716,0.702940368,-1628,1628,-0.447375653,0.447375653
Indiana,IN,Tippecanoe County,18,157,18157,Colts,#002c5f,185826,27207,30711,61916,0.439417921,0.496010724,-3504,3504,-0.056592803,0.056592803
Indiana,IN,Tipton County,18,159,18159,Colts,#002c5f,15267,1587,5589,7510,0.211318242,0.744207723,-4002,4002,-0.532889481,0.532889481
Indiana,IN,Union County,18,161,18161,Colts,#002c5f,7182,715,2445,3286,0.217589775,0.744065733,-1730,1730,-0.526475959,0.526475959
Indiana,IN,Vanderburgh County,18,163,18163,Colts,#002c5f,181877,28296,40422,71957,0.393234849,0.561752158,-12126,12126,-0.168517309,0.168517309
Indiana,IN,Vermillion County,18,165,18165,Colts,#002c5f,15692,2081,4511,6913,0.30102705,0.652538695,-2430,2430,-0.351511645,0.351511645
Indiana,IN,Vigo County,18,167,18167,Colts,#002c5f,107896,15922,21924,39569,0.402385706,0.554070105,-6002,6002,-0.151684399,0.151684399
Indiana,IN,Wabash County,18,169,18169,Colts,#002c5f,32138,3018,9819,13415,0.224972046,0.731941856,-6801,6801,-0.50696981,0.50696981
Indiana,IN,Warren County,18,171,18171,Colts,#002c5f,8269,839,2896,3919,0.214085226,0.738964021,-2057,2057,-0.524878796,0.524878796
Indiana,IN,Warrick County,18,173,18173,Colts,#002c5f,61897,9086,19133,29609,0.306866156,0.646188659,-10047,10047,-0.339322503,0.339322503
Indiana,IN,Washington County,18,175,18175,Colts,#002c5f,27827,2636,8206,11333,0.232595076,0.72408012,-5570,5570,-0.491485044,0.491485044
Indiana,IN,Wayne County,18,177,18177,Colts,#002c5f,67001,8322,16028,25575,0.325395894,0.626705767,-7706,7706,-0.301309873,0.301309873
Indiana,IN,Wells County,18,179,18179,Colts,#002c5f,27964,2585,9999,13123,0.196982397,0.761944677,-7414,7414,-0.56496228,0.56496228
Indiana,IN,White County,18,181,18181,Colts,#002c5f,24293,2563,6813,9902,0.258836599,0.68804282,-4250,4250,-0.429206221,0.429206221
Indiana,IN,Whitley County,18,183,18183,Colts,#002c5f,33406,3379,11357,15535,0.217508851,0.731058899,-7978,7978,-0.513550048,0.513550048
Iowa,IA,Adair County,19,1,19001,Packers,#203731,7228,1127,2456,3759,0.29981378,0.653365257,-1329,1329,-0.353551476,0.353551476
Iowa,IA,Adams County,19,3,19003,Chiefs,#e31837,3796,565,1393,2082,0.271373679,0.669068204,-828,828,-0.397694524,0.397694524
Iowa,IA,Allamakee County,19,5,19005,Packers,#203731,13886,2409,4072,6837,0.352347521,0.595582858,-1663,1663,-0.243235337,0.243235337
Iowa,IA,Appanoose County,19,7,19007,Cowboys,#002244,12529,1813,4031,6096,0.297408136,0.661253281,-2218,2218,-0.363845144,0.363845144
Iowa,IA,Audubon County,19,9,19009,Chiefs,#e31837,5773,1079,2135,3379,0.319325244,0.631843741,-1056,1056,-0.312518497,0.312518497
Iowa,IA,Benton County,19,11,19011,Bears,#c83803,25658,4672,8226,13690,0.341271001,0.600876552,-3554,3554,-0.259605551,0.259605551
Iowa,IA,Black Hawk County,19,13,19013,Bears,#c83803,133455,32006,27382,63221,0.506255833,0.433115579,4624,-4624,0.073140254,-0.073140254
Iowa,IA,Boone County,19,15,19015,Vikings,#4f2683,26643,5517,7458,13984,0.394522311,0.533323799,-1941,1941,-0.138801487,0.138801487
Iowa,IA,Bremer County,19,17,19017,Vikings,#4f2683,24722,5349,7199,13350,0.400674157,0.539250936,-1850,1850,-0.138576779,0.138576779
Iowa,IA,Buchanan County,19,19,19019,Bears,#c83803,21062,3966,5504,10137,0.391240012,0.542961428,-1538,1538,-0.151721417,0.151721417
Iowa,IA,Buena Vista County,19,21,19021,Vikings,#4f2683,20493,2851,4895,8179,0.34857562,0.598483922,-2044,2044,-0.249908302,0.249908302
Iowa,IA,Butler County,19,23,19023,Vikings,#4f2683,14915,2163,4918,7457,0.290063028,0.65951455,-2755,2755,-0.369451522,0.369451522
Iowa,IA,Calhoun County,19,25,19025,Vikings,#4f2683,9818,1396,3466,5105,0.273457395,0.678942214,-2070,2070,-0.405484819,0.405484819
Iowa,IA,Carroll County,19,27,19027,Vikings,#4f2683,20498,3305,6627,10435,0.316722568,0.635074269,-3322,3322,-0.318351701,0.318351701
Iowa,IA,Cass County,19,29,19029,Chiefs,#e31837,13427,1946,4755,7055,0.275832743,0.673990078,-2809,2809,-0.398157335,0.398157335
Iowa,IA,Cedar County,19,31,19031,Bears,#c83803,18340,3578,5275,9386,0.381206052,0.562007245,-1697,1697,-0.180801193,0.180801193
Iowa,IA,Cerro Gordo County,19,33,19033,Vikings,#4f2683,43017,9840,11583,22633,0.434763399,0.511774842,-1743,1743,-0.077011443,0.077011443
Iowa,IA,Cherokee County,19,35,19035,Vikings,#4f2683,11574,1676,4188,6186,0.270934368,0.677012609,-2512,2512,-0.406078241,0.406078241
Iowa,IA,Chickasaw County,19,37,19037,Vikings,#4f2683,12097,2264,3739,6367,0.355583477,0.587246741,-1475,1475,-0.231663264,0.231663264
Iowa,IA,Clarke County,19,39,19039,Packers,#203731,9259,1463,2706,4405,0.332122588,0.61430193,-1243,1243,-0.282179342,0.282179342
Iowa,IA,Clay County,19,41,19041,Vikings,#4f2683,16507,2246,5870,8542,0.262936081,0.687192695,-3624,3624,-0.424256614,0.424256614
Iowa,IA,Clayton County,19,43,19043,Packers,#203731,17644,3236,5309,9098,0.355682568,0.583534843,-2073,2073,-0.227852275,0.227852275
Iowa,IA,Clinton County,19,45,19045,Bears,#c83803,47768,10079,11249,22748,0.443071918,0.494505011,-1170,1170,-0.051433093,0.051433093
Iowa,IA,Crawford County,19,47,19047,Cowboys,#002244,17094,1985,4608,6862,0.289274264,0.671524337,-2623,2623,-0.382250073,0.382250073
Iowa,IA,Dallas County,19,49,19049,Packers,#203731,80133,15662,19288,37617,0.416354308,0.512746896,-3626,3626,-0.096392588,0.096392588
Iowa,IA,Davis County,19,51,19051,Packers,#203731,8769,976,2721,3858,0.252980819,0.705287714,-1745,1745,-0.452306895,0.452306895
Iowa,IA,Decatur County,19,53,19053,Chiefs,#e31837,8220,1201,2296,3703,0.324331623,0.620037807,-1095,1095,-0.295706184,0.295706184
Iowa,IA,Delaware County,19,55,19055,Packers,#203731,17403,2956,5688,9165,0.322531369,0.620621931,-2732,2732,-0.298090562,0.298090562
Iowa,IA,Des Moines County,19,57,19057,Bears,#c83803,40055,8178,9479,18713,0.437022391,0.506546251,-1301,1301,-0.06952386,0.06952386
Iowa,IA,Dickinson County,19,59,19059,Vikings,#4f2683,17111,3051,6743,10247,0.297745682,0.658046257,-3692,3692,-0.360300576,0.360300576
Iowa,IA,Dubuque County,19,61,19061,Bears,#c83803,97125,22774,23384,49037,0.464424822,0.476864409,-610,610,-0.012439586,0.012439586
Iowa,IA,Emmet County,19,63,19063,Vikings,#4f2683,9769,1356,3121,4707,0.288081581,0.663055024,-1765,1765,-0.374973444,0.374973444
Iowa,IA,Fayette County,19,65,19065,Packers,#203731,20257,3666,5591,9813,0.373586059,0.569754407,-1925,1925,-0.196168348,0.196168348
Iowa,IA,Floyd County,19,67,19067,Vikings,#4f2683,15960,3177,4371,7985,0.397871008,0.547401378,-1194,1194,-0.149530369,0.149530369
Iowa,IA,Franklin County,19,69,19069,Vikings,#4f2683,10295,1490,3153,4915,0.303153611,0.641505595,-1663,1663,-0.338351984,0.338351984
Iowa,IA,Fremont County,19,71,19071,Chiefs,#e31837,6906,959,2401,3554,0.269836804,0.675576815,-1442,1442,-0.405740011,0.405740011
Iowa,IA,Greene County,19,73,19073,Vikings,#4f2683,9027,1688,2819,4762,0.354472911,0.59197816,-1131,1131,-0.23750525,0.23750525
Iowa,IA,Grundy County,19,75,19075,Packers,#203731,12435,1847,4516,6766,0.27298256,0.667454922,-2669,2669,-0.394472362,0.394472362
Iowa,IA,Guthrie County,19,77,19077,Packers,#203731,10676,1720,3603,5654,0.304209409,0.637247966,-1883,1883,-0.333038557,0.333038557
Iowa,IA,Hamilton County,19,79,19079,Vikings,#4f2683,15190,2715,4450,7589,0.357754645,0.586375016,-1735,1735,-0.228620372,0.228620372
Iowa,IA,Hancock County,19,81,19081,Vikings,#4f2683,10974,1582,3972,5815,0.27205503,0.683061049,-2390,2390,-0.411006019,0.411006019
Iowa,IA,Hardin County,19,83,19083,Vikings,#4f2683,17367,2774,5231,8423,0.329336341,0.621037635,-2457,2457,-0.291701294,0.291701294
Iowa,IA,Harrison County,19,85,19085,Chiefs,#e31837,14265,2123,4892,7378,0.287747357,0.663052318,-2769,2769,-0.375304961,0.375304961
Iowa,IA,Henry County,19,87,19087,Bears,#c83803,19950,2897,5764,9286,0.311975016,0.620719362,-2867,2867,-0.308744346,0.308744346
Iowa,IA,Howard County,19,89,19089,Vikings,#4f2683,9410,1674,2611,4507,0.371422232,0.579321056,-937,937,-0.207898824,0.207898824
Iowa,IA,Humboldt County,19,91,19091,Vikings,#4f2683,9555,1251,3564,5033,0.248559507,0.708126366,-2313,2313,-0.459566859,0.459566859
Iowa,IA,Ida County,19,93,19093,Vikings,#4f2683,7028,792,2655,3590,0.220612813,0.739554318,-1863,1863,-0.518941504,0.518941504
Iowa,IA,Iowa County,19,95,19095,Bears,#c83803,16401,3070,5193,8789,0.349300262,0.590852202,-2123,2123,-0.24155194,0.24155194
Iowa,IA,Jackson County,19,97,19097,Bears,#c83803,19444,3837,5821,10204,0.376029008,0.570462564,-1984,1984,-0.194433555,0.194433555
Iowa,IA,Jasper County,19,99,19099,Bears,#c83803,36827,7108,10556,18776,0.378568385,0.562207073,-3448,3448,-0.183638688,0.183638688
Iowa,IA,Jefferson County,19,101,19101,Packers,#203731,17555,3702,3738,8001,0.462692163,0.467191601,-36,36,-0.004499438,0.004499438
Iowa,IA,Johnson County,19,103,19103,Bears,#c83803,144251,49942,20993,75637,0.66028531,0.277549348,28949,-28949,0.382735963,-0.382735963
Iowa,IA,Jones County,19,105,19105,Bears,#c83803,20466,3779,5718,10011,0.377484767,0.571171711,-1939,1939,-0.193686944,0.193686944
Iowa,IA,Keokuk County,19,107,19107,Bears,#c83803,10163,1265,3385,4858,0.260395224,0.696788802,-2120,2120,-0.436393578,0.436393578
Iowa,IA,Kossuth County,19,109,19109,Vikings,#4f2683,15165,2529,5637,8505,0.297354497,0.662786596,-3108,3108,-0.365432099,0.365432099
Iowa,IA,Lee County,19,111,19111,Bears,#c83803,35089,6195,8762,15893,0.389794249,0.551311898,-2567,2567,-0.161517649,0.161517649
Iowa,IA,Linn County,19,113,19113,Bears,#c83803,219916,58481,48183,114664,0.510020582,0.420210354,10298,-10298,0.089810228,-0.089810228
Iowa,IA,Louisa County,19,115,19115,Bears,#c83803,11185,1643,3060,4943,0.332389237,0.619057253,-1417,1417,-0.286668015,0.286668015
Iowa,IA,Lucas County,19,117,19117,Cowboys,#002244,8682,1236,2873,4297,0.287642541,0.668606004,-1637,1637,-0.380963463,0.380963463
Iowa,IA,Lyon County,19,119,19119,Vikings,#4f2683,11745,917,5188,6336,0.144728535,0.818813131,-4271,4271,-0.674084596,0.674084596
Iowa,IA,Madison County,19,121,19121,Packers,#203731,15753,2666,5336,8523,0.312800657,0.626070632,-2670,2670,-0.313269975,0.313269975
Iowa,IA,Mahaska County,19,123,19123,Packers,#203731,22324,2606,7404,10494,0.24833238,0.705546026,-4798,4798,-0.457213646,0.457213646
Iowa,IA,Marion County,19,125,19125,Bears,#c83803,33294,5469,10940,17554,0.311552922,0.623219779,-5471,5471,-0.311666857,0.311666857
Iowa,IA,Marshall County,19,127,19127,Packers,#203731,40746,7623,9125,17700,0.430677966,0.515536723,-1502,1502,-0.084858757,0.084858757
Iowa,IA,Mills County,19,129,19129,Chiefs,#e31837,14844,2080,5050,7608,0.273396425,0.663774974,-2970,2970,-0.390378549,0.390378549
Iowa,IA,Mitchell County,19,131,19131,Vikings,#4f2683,10832,1879,3180,5360,0.350559701,0.593283582,-1301,1301,-0.242723881,0.242723881
Iowa,IA,Monona County,19,133,19133,Packers,#203731,8979,1244,3115,4525,0.274917127,0.68839779,-1871,1871,-0.413480663,0.413480663
Iowa,IA,Monroe County,19,135,19135,Bears,#c83803,7973,1053,2635,3844,0.273933403,0.685483871,-1582,1582,-0.411550468,0.411550468
Iowa,IA,Montgomery County,19,137,19137,Chiefs,#e31837,10234,1312,3431,4998,0.262505002,0.68647459,-2119,2119,-0.423969588,0.423969588
Iowa,IA,Muscatine County,19,139,19139,Bears,#c83803,43011,8284,9549,19086,0.434035419,0.500314367,-1265,1265,-0.066278948,0.066278948
Iowa,IA,O'Brien County,19,141,19141,Vikings,#4f2683,13984,1314,5735,7348,0.17882417,0.780484486,-4421,4421,-0.601660316,0.601660316
Iowa,IA,Osceola County,19,143,19143,Vikings,#4f2683,6154,552,2528,3197,0.172661871,0.79074132,-1976,1976,-0.618079449,0.618079449
Iowa,IA,Page County,19,145,19145,Chiefs,#e31837,15527,1801,4875,6968,0.258467279,0.699626866,-3074,3074,-0.441159587,0.441159587
Iowa,IA,Palo Alto County,19,147,19147,Vikings,#4f2683,9133,1395,3079,4674,0.298459564,0.658750535,-1684,1684,-0.360290971,0.360290971
Iowa,IA,Plymouth County,19,149,19149,Vikings,#4f2683,24800,2878,9659,13057,0.220418167,0.739756452,-6781,6781,-0.519338286,0.519338286
Iowa,IA,Pocahontas County,19,151,19151,Vikings,#4f2683,7008,962,2692,3831,0.251109371,0.702688593,-1730,1730,-0.451579222,0.451579222
Iowa,IA,Polk County,19,153,19153,Bears,#c83803,467711,119671,93421,228420,0.523907714,0.408987829,26250,-26250,0.114919884,-0.114919884
Iowa,IA,Pottawattamie County,19,155,19155,Cowboys,#002244,93671,15341,24441,42226,0.363306967,0.578814001,-9100,9100,-0.215507034,0.215507034
Iowa,IA,Poweshiek County,19,157,19157,Packers,#203731,18550,4272,4936,9693,0.440730424,0.509233467,-664,664,-0.068503043,0.068503043
Iowa,IA,Ringgold County,19,159,19159,Chiefs,#e31837,5068,753,1820,2684,0.280551416,0.678092399,-1067,1067,-0.397540984,0.397540984
Iowa,IA,Sac County,19,161,19161,Vikings,#4f2683,10021,1269,3692,5158,0.246025591,0.715781311,-2423,2423,-0.469755719,0.469755719
Iowa,IA,Scott County,19,163,19163,Bears,#c83803,172126,40302,39083,84878,0.474822687,0.460460897,1219,-1219,0.01436179,-0.01436179
Iowa,IA,Shelby County,19,165,19165,Chiefs,#e31837,11927,1649,4340,6270,0.262998405,0.692185008,-2691,2691,-0.429186603,0.429186603
Iowa,IA,Sioux County,19,167,19167,Vikings,#4f2683,34937,2289,14761,17989,0.127244427,0.820557007,-12472,12472,-0.69331258,0.69331258
Iowa,IA,Story County,19,169,19169,Packers,#203731,96021,25085,19111,48910,0.512880801,0.39073809,5974,-5974,0.122142711,-0.122142711
Iowa,IA,Tama County,19,171,19171,Packers,#203731,17337,3194,4968,8636,0.369847151,0.575266327,-1774,1774,-0.205419176,0.205419176
Iowa,IA,Taylor County,19,173,19173,Chiefs,#e31837,6205,755,2108,3003,0.251415251,0.701964702,-1353,1353,-0.450549451,0.450549451
Iowa,IA,Union County,19,175,19175,Chiefs,#e31837,12469,1920,3521,5768,0.332871012,0.610436893,-1601,1601,-0.277565881,0.277565881
Iowa,IA,Van Buren County,19,177,19177,Bears,#c83803,7344,843,2524,3526,0.239081112,0.715825298,-1681,1681,-0.476744186,0.476744186
Iowa,IA,Wapello County,19,179,19179,Packers,#203731,35173,5591,8710,14996,0.372832755,0.580821552,-3119,3119,-0.207988797,0.207988797
Iowa,IA,Warren County,19,181,19181,Bears,#c83803,48626,10371,14773,26916,0.385309853,0.548855699,-4402,4402,-0.163545846,0.163545846
Iowa,IA,Washington County,19,183,19183,Bears,#c83803,22247,3938,6170,10824,0.363821138,0.570029564,-2232,2232,-0.206208426,0.206208426
Iowa,IA,Wayne County,19,185,19185,Packers,#203731,6385,719,2069,2921,0.246148579,0.708319069,-1350,1350,-0.46217049,0.46217049
Iowa,IA,Webster County,19,187,19187,Vikings,#4f2683,37071,6293,10049,17239,0.365044376,0.582922443,-3756,3756,-0.217878067,0.217878067
Iowa,IA,Winnebago County,19,189,19189,Vikings,#4f2683,10609,1920,3437,5717,0.335840476,0.601189435,-1517,1517,-0.265348959,0.265348959
Iowa,IA,Winneshiek County,19,191,19191,Packers,#203731,20709,5238,5332,11217,0.466969778,0.475349915,-94,94,-0.008380137,0.008380137
Iowa,IA,Woodbury County,19,193,19193,Vikings,#4f2683,102782,16102,24627,42933,0.375049496,0.573614702,-8525,8525,-0.198565206,0.198565206
Iowa,IA,Worth County,19,195,19195,Vikings,#4f2683,7569,1523,2443,4216,0.361242884,0.579459203,-920,920,-0.218216319,0.218216319
Iowa,IA,Wright County,19,197,19197,Vikings,#4f2683,12773,1890,3790,5949,0.317700454,0.637081862,-1900,1900,-0.319381409,0.319381409
Kansas,KS,Allen County,20,1,20001,Chiefs,#e31837,12717,1398,3575,5314,0.26307866,0.672751223,-2177,2177,-0.409672563,0.409672563
Kansas,KS,Anderson County,20,3,20003,Chiefs,#e31837,7808,665,2386,3277,0.202929509,0.728104974,-1721,1721,-0.525175465,0.525175465
Kansas,KS,Atchison County,20,5,20005,Chiefs,#e31837,16398,1946,3977,6393,0.304395433,0.622086657,-2031,2031,-0.317691225,0.317691225
Kansas,KS,Barber County,20,7,20007,Chiefs,#e31837,4823,281,1822,2209,0.127206881,0.824807605,-1541,1541,-0.697600724,0.697600724
Kansas,KS,Barton County,20,9,20009,Chiefs,#e31837,27103,1823,7766,10088,0.180709754,0.769825535,-5943,5943,-0.589115781,0.589115781
Kansas,KS,Bourbon County,20,11,20011,Chiefs,#e31837,14712,1306,4314,5918,0.220682663,0.728962487,-3008,3008,-0.508279824,0.508279824
Kansas,KS,Brown County,20,13,20013,Chiefs,#e31837,9776,850,2861,3960,0.214646465,0.722474747,-2011,2011,-0.507828283,0.507828283
Kansas,KS,Butler County,20,15,20015,Chiefs,#e31837,66741,6489,18781,27051,0.239880226,0.694281173,-12292,12292,-0.454400946,0.454400946
Kansas,KS,Chase County,20,17,20017,Chiefs,#e31837,2679,313,964,1342,0.233233979,0.718330849,-651,651,-0.48509687,0.48509687
Kansas,KS,Chautauqua County,20,19,20019,Chiefs,#e31837,3402,236,1552,1845,0.127913279,0.841192412,-1316,1316,-0.713279133,0.713279133
Kansas,KS,Cherokee County,20,21,20021,Chiefs,#e31837,20533,1959,6017,8386,0.233603625,0.717505366,-4058,4058,-0.483901741,0.483901741
Kansas,KS,Cheyenne County,20,23,20023,Broncos,#fb4f14,2679,188,1172,1409,0.133427963,0.8317956,-984,984,-0.698367637,0.698367637
Kansas,KS,Clark County,20,25,20025,Chiefs,#e31837,2096,118,813,983,0.120040692,0.82706002,-695,695,-0.707019329,0.707019329
Kansas,KS,Clay County,20,27,20027,Chiefs,#e31837,8347,665,2831,3727,0.17842769,0.759592165,-2166,2166,-0.581164475,0.581164475
Kansas,KS,Cloud County,20,29,20029,Chiefs,#e31837,9219,744,2856,3831,0.194205168,0.745497259,-2112,2112,-0.551292091,0.551292091
Kansas,KS,Coffey County,20,31,20031,Chiefs,#e31837,8384,719,2990,3962,0.181474003,0.754669359,-2271,2271,-0.573195356,0.573195356
Kansas,KS,Comanche County,20,33,20033,Chiefs,#e31837,1843,102,705,857,0.119019837,0.822637106,-603,603,-0.70361727,0.70361727
Kansas,KS,Cowley County,20,35,20035,Chiefs,#e31837,35788,3436,8016,12171,0.28231041,0.65861474,-4580,4580,-0.37630433,0.37630433
Kansas,KS,Crawford County,20,37,20037,Chiefs,#e31837,39217,5064,8394,14404,0.351569009,0.58275479,-3330,3330,-0.231185782,0.231185782
Kansas,KS,Decatur County,20,39,20039,Broncos,#fb4f14,2932,178,1220,1460,0.121917808,0.835616438,-1042,1042,-0.71369863,0.71369863
Kansas,KS,Dickinson County,20,41,20041,Chiefs,#e31837,19303,1582,5905,8008,0.197552448,0.737387612,-4323,4323,-0.539835165,0.539835165
Kansas,KS,Doniphan County,20,43,20043,Chiefs,#e31837,7797,584,2601,3366,0.173499703,0.772727273,-2017,2017,-0.59922757,0.59922757
Kansas,KS,Douglas County,20,45,20045,Chiefs,#e31837,118053,30089,14308,48231,0.623851879,0.296655678,15781,-15781,0.327196202,-0.327196202
Kansas,KS,Edwards County,20,47,20047,Chiefs,#e31837,2968,208,1033,1308,0.159021407,0.789755352,-825,825,-0.630733945,0.630733945
Kansas,KS,Elk County,20,49,20049,Chiefs,#e31837,2605,160,1048,1259,0.127084988,0.832406672,-888,888,-0.705321684,0.705321684
Kansas,KS,Ellis County,20,51,20051,Chiefs,#e31837,29029,2669,8311,11660,0.22890223,0.712778731,-5642,5642,-0.483876501,0.483876501
Kansas,KS,Ellsworth County,20,53,20053,Chiefs,#e31837,6343,515,1933,2626,0.196115765,0.736100533,-1418,1418,-0.539984768,0.539984768
Kansas,KS,Finney County,20,55,20055,Cowboys,#002244,37118,3006,6155,9731,0.30890967,0.632514644,-3149,3149,-0.323604974,0.323604974
Kansas,KS,Ford County,20,57,20057,Chiefs,#e31837,34536,2032,4994,7425,0.273670034,0.672592593,-2962,2962,-0.398922559,0.398922559
Kansas,KS,Franklin County,20,59,20059,Chiefs,#e31837,25609,2829,7025,10658,0.265434415,0.659129293,-4196,4196,-0.393694877,0.393694877
Kansas,KS,Geary County,20,61,20061,Cowboys,#002244,37030,2569,4116,7129,0.360359097,0.577360079,-1547,1547,-0.217000982,0.217000982
Kansas,KS,Gove County,20,63,20063,Broncos,#fb4f14,2640,149,1127,1328,0.112198795,0.848644578,-978,978,-0.736445783,0.736445783
Kansas,KS,Graham County,20,65,20065,Chiefs,#e31837,2591,185,1013,1265,0.146245059,0.800790514,-828,828,-0.654545455,0.654545455
Kansas,KS,Grant County,20,67,20067,Cowboys,#002244,7733,427,1755,2311,0.184768498,0.75941151,-1328,1328,-0.574643012,0.574643012
Kansas,KS,Gray County,20,69,20069,Chiefs,#e31837,6133,257,1651,2011,0.127797116,0.820984585,-1394,1394,-0.693187469,0.693187469
Kansas,KS,Greeley County,20,71,20071,Broncos,#fb4f14,1330,83,523,639,0.129890454,0.818466354,-440,440,-0.6885759,0.6885759
Kansas,KS,Greenwood County,20,73,20073,Chiefs,#e31837,6244,484,2146,2811,0.172180719,0.763429385,-1662,1662,-0.591248666,0.591248666
Kansas,KS,Hamilton County,20,75,20075,Broncos,#fb4f14,2474,114,690,847,0.13459268,0.814639906,-576,576,-0.680047226,0.680047226
Kansas,KS,Harper County,20,77,20077,Chiefs,#e31837,5817,388,1950,2513,0.154397135,0.775964982,-1562,1562,-0.621567847,0.621567847
Kansas,KS,Harvey County,20,79,20079,Chiefs,#e31837,35073,5006,8503,14540,0.344291609,0.58480055,-3497,3497,-0.240508941,0.240508941
Kansas,KS,Haskell County,20,81,20081,Chiefs,#e31837,4064,228,1011,1300,0.175384615,0.777692308,-783,783,-0.602307692,0.602307692
Kansas,KS,Hodgeman County,20,83,20083,Chiefs,#e31837,1893,124,845,1006,0.123260437,0.839960239,-721,721,-0.716699801,0.716699801
Kansas,KS,Jackson County,20,85,20085,Chiefs,#e31837,13338,1489,3888,5727,0.259996508,0.678889471,-2399,2399,-0.418892963,0.418892963
Kansas,KS,Jefferson County,20,87,20087,Chiefs,#e31837,18930,2483,5112,8151,0.304625199,0.627162311,-2629,2629,-0.322537112,0.322537112
Kansas,KS,Jewell County,20,89,20089,Chiefs,#e31837,2970,180,1204,1483,0.12137559,0.811867835,-1024,1024,-0.690492245,0.690492245
Kansas,KS,Johnson County,20,91,20091,Chiefs,#e31837,580159,126324,133907,279753,0.451555479,0.478661534,-7583,7583,-0.027106054,0.027106054
Kansas,KS,Kearny County,20,93,20093,Broncos,#fb4f14,3956,224,1048,1325,0.169056604,0.790943396,-824,824,-0.621886792,0.621886792
Kansas,KS,Kingman County,20,95,20095,Chiefs,#e31837,7687,594,2507,3281,0.181042365,0.764096312,-1913,1913,-0.583053947,0.583053947
Kansas,KS,Kiowa County,20,97,20097,Chiefs,#e31837,2564,111,855,1023,0.108504399,0.835777126,-744,744,-0.727272727,0.727272727
Kansas,KS,Labette County,20,99,20099,Chiefs,#e31837,20803,2234,5232,7919,0.282106327,0.660689481,-2998,2998,-0.378583154,0.378583154
Kansas,KS,Lane County,20,101,20101,Chiefs,#e31837,1670,104,684,831,0.125150421,0.823104693,-580,580,-0.697954272,0.697954272
Kansas,KS,Leavenworth County,20,103,20103,Chiefs,#e31837,79315,10064,17387,29676,0.339129263,0.585894325,-7323,7323,-0.246765063,0.246765063
Kansas,KS,Lincoln County,20,105,20105,Chiefs,#e31837,3105,214,1168,1448,0.147790055,0.806629834,-954,954,-0.658839779,0.658839779
Kansas,KS,Linn County,20,107,20107,Chiefs,#e31837,9536,721,3377,4279,0.168497312,0.789203085,-2656,2656,-0.620705772,0.620705772
Kansas,KS,Logan County,20,109,20109,Broncos,#fb4f14,2825,149,1124,1348,0.110534125,0.833827893,-975,975,-0.723293769,0.723293769
Kansas,KS,Lyon County,20,111,20111,Chiefs,#e31837,33339,4456,6354,11745,0.379395487,0.540996169,-1898,1898,-0.161600681,0.161600681
Kansas,KS,McPherson County,20,113,20113,Chiefs,#e31837,28941,3183,8407,12443,0.255806478,0.675640923,-5224,5224,-0.419834445,0.419834445
Kansas,KS,Marion County,20,115,20115,Chiefs,#e31837,12103,1177,3928,5465,0.21537054,0.718755718,-2751,2751,-0.503385178,0.503385178
Kansas,KS,Marshall County,20,117,20117,Chiefs,#e31837,9936,1060,3250,4578,0.231542158,0.709916994,-2190,2190,-0.478374836,0.478374836
Kansas,KS,Meade County,20,119,20119,Chiefs,#e31837,4330,206,1390,1675,0.122985075,0.829850746,-1184,1184,-0.706865672,0.706865672
Kansas,KS,Miami County,20,121,20121,Chiefs,#e31837,32553,3949,9839,14712,0.268420337,0.66877379,-5890,5890,-0.400353453,0.400353453
Kansas,KS,Mitchell County,20,123,20123,Chiefs,#e31837,6282,469,2216,2824,0.166076487,0.78470255,-1747,1747,-0.618626062,0.618626062
Kansas,KS,Montgomery County,20,125,20125,Chiefs,#e31837,33314,2557,8466,11623,0.219994838,0.728383378,-5909,5909,-0.50838854,0.50838854
Kansas,KS,Morris County,20,127,20127,Chiefs,#e31837,5645,586,1790,2568,0.228193146,0.697040498,-1204,1204,-0.468847352,0.468847352
Kansas,KS,Morton County,20,129,20129,Cowboys,#002244,3007,145,970,1160,0.125,0.836206897,-825,825,-0.711206897,0.711206897
Kansas,KS,Nemaha County,20,131,20131,Chiefs,#e31837,10227,714,4066,5025,0.142089552,0.809154229,-3352,3352,-0.667064677,0.667064677
Kansas,KS,Neosho County,20,133,20133,Chiefs,#e31837,16346,1464,4340,6151,0.23801008,0.705576329,-2876,2876,-0.467566249,0.467566249
Kansas,KS,Ness County,20,135,20135,Chiefs,#e31837,3005,160,1216,1435,0.111498258,0.84738676,-1056,1056,-0.735888502,0.735888502
Kansas,KS,Norton County,20,137,20137,Chiefs,#e31837,5550,277,1808,2190,0.126484018,0.825570776,-1531,1531,-0.699086758,0.699086758
Kansas,KS,Osage County,20,139,20139,Chiefs,#e31837,15847,1730,4713,6894,0.250942849,0.683637946,-2983,2983,-0.432695097,0.432695097
Kansas,KS,Osborne County,20,141,20141,Chiefs,#e31837,3683,231,1437,1753,0.131774102,0.819737593,-1206,1206,-0.687963491,0.687963491
Kansas,KS,Ottawa County,20,143,20143,Chiefs,#e31837,5975,424,2261,2866,0.147941382,0.788904396,-1837,1837,-0.640963015,0.640963015
Kansas,KS,Pawnee County,20,145,20145,Chiefs,#e31837,6838,567,1872,2602,0.217909301,0.71944658,-1305,1305,-0.501537279,0.501537279
Kansas,KS,Phillips County,20,147,20147,Chiefs,#e31837,5428,296,2200,2611,0.113366526,0.842589046,-1904,1904,-0.72922252,0.72922252
Kansas,KS,Pottawatomie County,20,149,20149,Chiefs,#e31837,23298,2191,7451,10359,0.211506902,0.719277923,-5260,5260,-0.50777102,0.50777102
Kansas,KS,Pratt County,20,151,20151,Chiefs,#e31837,9691,769,2824,3806,0.202049396,0.741986337,-2055,2055,-0.539936942,0.539936942
Kansas,KS,Rawlins County,20,153,20153,Broncos,#fb4f14,2506,160,1209,1448,0.110497238,0.834944751,-1049,1049,-0.724447514,0.724447514
Kansas,KS,Reno County,20,155,20155,Chiefs,#e31837,63718,6670,15100,23448,0.284459229,0.643978164,-8430,8430,-0.359518936,0.359518936
Kansas,KS,Republic County,20,157,20157,Chiefs,#e31837,4725,370,1993,2484,0.148953301,0.802334944,-1623,1623,-0.653381643,0.653381643
Kansas,KS,Rice County,20,159,20159,Chiefs,#e31837,9977,668,2652,3567,0.187272218,0.743481918,-1984,1984,-0.5562097,0.5562097
Kansas,KS,Riley County,20,161,20161,Chiefs,#e31837,75247,8892,9817,20475,0.434285714,0.479462759,-925,925,-0.045177045,0.045177045
Kansas,KS,Rooks County,20,163,20163,Chiefs,#e31837,5174,273,1999,2378,0.114802355,0.840622372,-1726,1726,-0.725820017,0.725820017
Kansas,KS,Rush County,20,165,20165,Chiefs,#e31837,3130,227,1177,1474,0.154002714,0.798507463,-950,950,-0.644504749,0.644504749
Kansas,KS,Russell County,20,167,20167,Chiefs,#e31837,7039,454,2544,3148,0.144218551,0.808132147,-2090,2090,-0.663913596,0.663913596
Kansas,KS,Saline County,20,169,20169,Chiefs,#e31837,55691,6084,13367,21206,0.286899934,0.63034047,-7283,7283,-0.343440536,0.343440536
Kansas,KS,Scott County,20,171,20171,Chiefs,#e31837,4964,232,1832,2159,0.107457156,0.848540991,-1600,1600,-0.741083835,0.741083835
Kansas,KS,Sedgwick County,20,173,20173,Chiefs,#e31837,511574,66716,101319,180750,0.369106501,0.560547718,-34603,34603,-0.191441217,0.191441217
Kansas,KS,Seward County,20,175,20175,Cowboys,#002244,23152,1491,3025,4743,0.314358001,0.637781995,-1534,1534,-0.323423993,0.323423993
Kansas,KS,Shawnee County,20,177,20177,Chiefs,#e31837,178725,33270,35349,73648,0.451743428,0.479972301,-2079,2079,-0.028228872,0.028228872
Kansas,KS,Sheridan County,20,179,20179,Chiefs,#e31837,2512,126,1186,1362,0.092511013,0.870778267,-1060,1060,-0.778267254,0.778267254
Kansas,KS,Sherman County,20,181,20181,Broncos,#fb4f14,5983,340,2043,2537,0.134016555,0.805281829,-1703,1703,-0.671265274,0.671265274
Kansas,KS,Smith County,20,183,20183,Chiefs,#e31837,3704,295,1635,2014,0.146474677,0.811817279,-1340,1340,-0.665342602,0.665342602
Kansas,KS,Stafford County,20,185,20185,Chiefs,#e31837,4236,303,1485,1884,0.160828025,0.788216561,-1182,1182,-0.627388535,0.627388535
Kansas,KS,Stanton County,20,187,20187,Broncos,#fb4f14,2072,132,580,742,0.177897574,0.781671159,-448,448,-0.603773585,0.603773585
Kansas,KS,Stevens County,20,189,20189,Cowboys,#002244,5806,215,1564,1853,0.116028063,0.844036697,-1349,1349,-0.728008635,0.728008635
Kansas,KS,Sumner County,20,191,20191,Chiefs,#e31837,23535,2039,6844,9494,0.214767221,0.720876343,-4805,4805,-0.506109122,0.506109122
Kansas,KS,Thomas County,20,193,20193,Broncos,#fb4f14,7904,467,2832,3483,0.134079816,0.813092162,-2365,2365,-0.679012346,0.679012346
Kansas,KS,Trego County,20,195,20195,Chiefs,#e31837,2927,193,1211,1459,0.132282385,0.830020562,-1018,1018,-0.697738177,0.697738177
Kansas,KS,Wabaunsee County,20,197,20197,Chiefs,#e31837,6951,773,2358,3340,0.231437126,0.705988024,-1585,1585,-0.474550898,0.474550898
Kansas,KS,Wallace County,20,199,20199,Broncos,#fb4f14,1518,45,711,779,0.057766367,0.912708601,-666,666,-0.854942234,0.854942234
Kansas,KS,Washington County,20,201,20201,Chiefs,#e31837,5598,378,2136,2677,0.141202839,0.797908106,-1758,1758,-0.656705267,0.656705267
Kansas,KS,Wichita County,20,203,20203,Broncos,#fb4f14,2157,139,765,934,0.14882227,0.819057816,-626,626,-0.670235546,0.670235546
Kansas,KS,Wilson County,20,205,20205,Chiefs,#e31837,8856,550,2747,3482,0.157955198,0.788914417,-2197,2197,-0.630959219,0.630959219
Kansas,KS,Woodson County,20,207,20207,Chiefs,#e31837,3115,270,1063,1420,0.190140845,0.748591549,-793,793,-0.558450704,0.558450704
Kansas,KS,Wyandotte County,20,209,20209,Chiefs,#e31837,163369,29346,15520,47467,0.61824004,0.326963996,13826,-13826,0.291276044,-0.291276044
Kentucky,KY,Adair County,21,1,21001,Colts,#002c5f,19027,1323,6637,8228,0.160792416,0.806635877,-5314,5314,-0.645843461,0.645843461
Kentucky,KY,Allen County,21,3,21003,Titans,#c60c30,20640,1349,6466,8085,0.166852195,0.799752628,-5117,5117,-0.632900433,0.632900433
Kentucky,KY,Anderson County,21,5,21005,Bengals,#fb4f14,21979,2634,8242,11414,0.230769231,0.722095672,-5608,5608,-0.491326441,0.491326441
Kentucky,KY,Ballard County,21,7,21007,Steelers,#ffb612,8212,816,3161,4097,0.199170124,0.771540151,-2345,2345,-0.572370027,0.572370027
Kentucky,KY,Barren County,21,9,21009,Titans,#c60c30,43570,4275,13483,18473,0.231418827,0.729876035,-9208,9208,-0.498457208,0.498457208
Kentucky,KY,Bath County,21,11,21011,Bengals,#fb4f14,12228,1361,3082,4577,0.297356347,0.673366834,-1721,1721,-0.376010487,0.376010487
Kentucky,KY,Bell County,21,13,21013,Steelers,#ffb612,27337,1720,7764,9714,0.177064031,0.799258802,-6044,6044,-0.62219477,0.62219477
Kentucky,KY,Boone County,21,15,21015,Bengals,#fb4f14,127712,15026,39082,57550,0.2610947,0.679096438,-24056,24056,-0.418001738,0.418001738
Kentucky,KY,Bourbon County,21,17,21017,Bengals,#fb4f14,20116,2791,5569,8791,0.31748379,0.633488795,-2778,2778,-0.316005005,0.316005005
Kentucky,KY,Boyd County,21,19,21019,Bengals,#fb4f14,48325,6021,13591,20443,0.294526244,0.664824145,-7570,7570,-0.370297901,0.370297901
Kentucky,KY,Boyle County,21,21,21021,Bengals,#fb4f14,29809,4281,8040,12928,0.331141708,0.621905941,-3759,3759,-0.290764233,0.290764233
Kentucky,KY,Bracken County,21,23,21023,Bengals,#fb4f14,8321,705,2711,3522,0.200170358,0.769733106,-2006,2006,-0.569562748,0.569562748
Kentucky,KY,Breathitt County,21,25,21025,Bengals,#fb4f14,13484,1537,3991,5728,0.268331006,0.696752793,-2454,2454,-0.428421788,0.428421788
Kentucky,KY,Breckinridge County,21,27,21027,Colts,#002c5f,20018,1960,6484,8765,0.223616657,0.739760411,-4524,4524,-0.516143754,0.516143754
Kentucky,KY,Bullitt County,21,29,21029,Cowboys,#002244,78702,8255,26210,36036,0.229076479,0.727328227,-17955,17955,-0.498251748,0.498251748
Kentucky,KY,Butler County,21,31,21031,Cowboys,#002244,12938,947,4428,5575,0.169865471,0.79426009,-3481,3481,-0.624394619,0.624394619
Kentucky,KY,Caldwell County,21,33,21033,Steelers,#ffb612,12681,1260,4507,5972,0.210984595,0.754688547,-3247,3247,-0.543703952,0.543703952
Kentucky,KY,Calloway County,21,35,21035,Titans,#c60c30,38343,4749,10367,16039,0.296090779,0.646361993,-5618,5618,-0.350271214,0.350271214
Kentucky,KY,Campbell County,21,37,21037,Bengals,#fb4f14,92066,14658,25050,42471,0.345129618,0.589814226,-10392,10392,-0.244684608,0.244684608
Kentucky,KY,Carlisle County,21,39,21039,Steelers,#ffb612,4874,432,2094,2599,0.166217776,0.805694498,-1662,1662,-0.639476722,0.639476722
Kentucky,KY,Carroll County,21,41,21041,Bengals,#fb4f14,10699,1106,2588,3851,0.28719813,0.672033238,-1482,1482,-0.384835108,0.384835108
Kentucky,KY,Carter County,21,43,21043,Bengals,#fb4f14,27158,2276,7587,10267,0.221681114,0.738969514,-5311,5311,-0.5172884,0.5172884
Kentucky,KY,Casey County,21,45,21045,Bengals,#fb4f14,15808,767,5482,6438,0.119136378,0.851506679,-4715,4715,-0.732370301,0.732370301
Kentucky,KY,Christian County,21,47,21047,Titans,#c60c30,73309,7188,14108,22069,0.325705741,0.639267751,-6920,6920,-0.31356201,0.31356201
Kentucky,KY,Clark County,21,49,21049,Bengals,#fb4f14,35757,4706,10710,16193,0.290619403,0.6613969,-6004,6004,-0.370777496,0.370777496
Kentucky,KY,Clay County,21,51,21051,Bengals,#fb4f14,21013,752,5861,6762,0.111209701,0.866755398,-5109,5109,-0.755545697,0.755545697
Kentucky,KY,Clinton County,21,53,21053,Colts,#002c5f,10174,547,3809,4454,0.122810956,0.855186349,-3262,3262,-0.732375393,0.732375393
Kentucky,KY,Crittenden County,21,55,21055,Colts,#002c5f,9183,617,3290,4036,0.152874133,0.815163528,-2673,2673,-0.662289395,0.662289395
Kentucky,KY,Cumberland County,21,57,21057,Colts,#002c5f,6759,459,2502,3061,0.149950996,0.817379941,-2043,2043,-0.667428945,0.667428945
Kentucky,KY,Daviess County,21,59,21059,Colts,#002c5f,99259,14163,28907,45752,0.309560238,0.631819374,-14744,14744,-0.322259136,0.322259136
Kentucky,KY,Edmonson County,21,61,21061,Steelers,#ffb612,12007,979,4135,5239,0.186867723,0.789272762,-3156,3156,-0.602405039,0.602405039
Kentucky,KY,Elliott County,21,63,21063,Bengals,#fb4f14,7648,740,2000,2847,0.259922726,0.702493853,-1260,1260,-0.442571128,0.442571128
Kentucky,KY,Estill County,21,65,21065,Bengals,#fb4f14,14375,1108,4236,5538,0.200072228,0.764897075,-3128,3128,-0.564824847,0.564824847
Kentucky,KY,Fayette County,21,67,21067,Bengals,#fb4f14,314488,69776,56890,136112,0.512636652,0.417964617,12886,-12886,0.094672035,-0.094672035
Kentucky,KY,Fleming County,21,69,21069,Bengals,#fb4f14,14637,1348,4722,6250,0.21568,0.75552,-3374,3374,-0.53984,0.53984
Kentucky,KY,Floyd County,21,71,21071,Steelers,#ffb612,37756,4015,11993,16521,0.24302403,0.725924581,-7978,7978,-0.482900551,0.482900551
Kentucky,KY,Franklin County,21,73,21073,Bengals,#fb4f14,50375,10717,11819,23840,0.449538591,0.495763423,-1102,1102,-0.046224832,0.046224832
Kentucky,KY,Fulton County,21,75,21075,Cowboys,#002244,6238,774,1549,2381,0.325073499,0.650566989,-775,775,-0.32549349,0.32549349
Kentucky,KY,Gallatin County,21,77,21077,Bengals,#fb4f14,8636,749,2443,3334,0.224655069,0.732753449,-1694,1694,-0.50809838,0.50809838
Kentucky,KY,Garrard County,21,79,21079,Bengals,#fb4f14,17237,1453,5904,7613,0.190857743,0.775515565,-4451,4451,-0.584657822,0.584657822
Kentucky,KY,Grant County,21,81,21081,Bengals,#fb4f14,24757,1910,7268,9551,0.19997906,0.760967438,-5358,5358,-0.560988378,0.560988378
Kentucky,KY,Graves County,21,83,21083,Cowboys,#002244,37421,3308,12671,16582,0.199493427,0.764141841,-9363,9363,-0.564648414,0.564648414
Kentucky,KY,Grayson County,21,85,21085,Cowboys,#002244,26221,1959,8219,10564,0.185441121,0.77801969,-6260,6260,-0.592578569,0.592578569
Kentucky,KY,Green County,21,87,21087,Packers,#203731,11010,832,4372,5331,0.15606828,0.820108798,-3540,3540,-0.664040518,0.664040518
Kentucky,KY,Greenup County,21,89,21089,Bengals,#fb4f14,36068,4146,11546,16265,0.254903166,0.709867814,-7400,7400,-0.454964648,0.454964648
Kentucky,KY,Hancock County,21,91,21091,Colts,#002c5f,8692,1244,2788,4292,0.289841566,0.649580615,-1544,1544,-0.359739049,0.359739049
Kentucky,KY,Hardin County,21,93,21093,Steelers,#ffb612,106439,13944,26970,43113,0.323429128,0.625565375,-13026,13026,-0.302136247,0.302136247
Kentucky,KY,Harlan County,21,95,21095,Cowboys,#002244,27703,1372,9129,10744,0.127699181,0.849683544,-7757,7757,-0.721984363,0.721984363
Kentucky,KY,Harrison County,21,97,21097,Bengals,#fb4f14,18763,2031,5435,7774,0.261255467,0.699125289,-3404,3404,-0.437869822,0.437869822
Kentucky,KY,Hart County,21,99,21099,Cowboys,#002244,18454,1730,5320,7261,0.238259193,0.732681449,-3590,3590,-0.494422256,0.494422256
Kentucky,KY,Henderson County,21,101,21101,Colts,#002c5f,46407,6707,12159,19692,0.340595166,0.617458867,-5452,5452,-0.276863701,0.276863701
Kentucky,KY,Henry County,21,103,21103,Bengals,#fb4f14,15620,1828,4944,7142,0.255950714,0.692243069,-3116,3116,-0.436292355,0.436292355
Kentucky,KY,Hickman County,21,105,21105,Steelers,#ffb612,4612,449,1657,2157,0.208159481,0.768196569,-1208,1208,-0.560037089,0.560037089
Kentucky,KY,Hopkins County,21,107,21107,Titans,#c60c30,46222,4310,15277,20325,0.212054121,0.751635916,-10967,10967,-0.539581796,0.539581796
Kentucky,KY,Jackson County,21,109,21109,Bengals,#fb4f14,13352,482,4889,5497,0.087684191,0.889394215,-4407,4407,-0.801710024,0.801710024
Kentucky,KY,Jefferson County,21,111,21111,Steelers,#ffb612,763623,190824,143758,352778,0.540918084,0.407502735,47066,-47066,0.133415349,-0.133415349
Kentucky,KY,Jessamine County,21,113,21113,Bengals,#fb4f14,51961,6144,15474,23292,0.263781556,0.664348274,-9330,9330,-0.400566718,0.400566718
Kentucky,KY,Johnson County,21,115,21115,Steelers,#ffb612,23175,1250,8043,9560,0.130753138,0.841317992,-6793,6793,-0.710564854,0.710564854
Kentucky,KY,Kenton County,21,117,21117,Bengals,#fb4f14,165012,24213,42958,71905,0.336735971,0.597427161,-18745,18745,-0.26069119,0.26069119
Kentucky,KY,Knott County,21,119,21119,Bengals,#fb4f14,15693,1245,4357,5756,0.216296039,0.75694927,-3112,3112,-0.540653231,0.540653231
Kentucky,KY,Knox County,21,121,21121,Bengals,#fb4f14,31730,1761,9885,12001,0.146737772,0.82368136,-8124,8124,-0.676943588,0.676943588
Kentucky,KY,Larue County,21,123,21123,Cowboys,#002244,14241,1278,4799,6359,0.200974996,0.754678409,-3521,3521,-0.553703412,0.553703412
Kentucky,KY,Laurel County,21,125,21125,Bengals,#fb4f14,60094,3440,20592,24811,0.13864818,0.829954456,-17152,17152,-0.691306275,0.691306275
Kentucky,KY,Lawrence County,21,127,21127,Steelers,#ffb612,15745,1045,4816,6037,0.173099221,0.797747225,-3771,3771,-0.624648004,0.624648004
Kentucky,KY,Lee County,21,129,21129,Bengals,#fb4f14,6752,444,2151,2663,0.166729253,0.807735637,-1707,1707,-0.641006384,0.641006384
Kentucky,KY,Leslie County,21,131,21131,Bengals,#fb4f14,10711,400,4015,4487,0.089146423,0.894807221,-3615,3615,-0.805660798,0.805660798
Kentucky,KY,Letcher County,21,133,21133,Steelers,#ffb612,23123,1542,7293,9131,0.16887526,0.798707699,-5751,5751,-0.629832439,0.629832439
Kentucky,KY,Lewis County,21,135,21135,Bengals,#fb4f14,13682,785,4363,5293,0.148309087,0.82429624,-3578,3578,-0.675987153,0.675987153
Kentucky,KY,Lincoln County,21,137,21137,Bengals,#fb4f14,24463,1865,7338,9555,0.195185767,0.767974882,-5473,5473,-0.572789116,0.572789116
Kentucky,KY,Livingston County,21,139,21139,Bears,#c83803,9316,887,3570,4642,0.19108143,0.769065058,-2683,2683,-0.577983628,0.577983628
Kentucky,KY,Logan County,21,141,21141,Titans,#c60c30,26910,2755,7778,10896,0.252845081,0.713839941,-5023,5023,-0.46099486,0.46099486
Kentucky,KY,Lyon County,21,143,21143,Cowboys,#002244,8306,1045,2789,3959,0.263955544,0.704470826,-1744,1744,-0.440515282,0.440515282
Kentucky,KY,McCracken County,21,145,21145,Steelers,#ffb612,65018,9134,20774,31284,0.291970336,0.664045518,-11640,11640,-0.372075182,0.372075182
Kentucky,KY,McCreary County,21,147,21147,Bengals,#fb4f14,17878,664,5012,5772,0.115038115,0.868329868,-4348,4348,-0.753291753,0.753291753
Kentucky,KY,McLean County,21,149,21149,Cowboys,#002244,9512,988,3381,4565,0.216429354,0.740635268,-2393,2393,-0.524205915,0.524205915
Kentucky,KY,Madison County,21,151,21151,Bengals,#fb4f14,87824,11793,23431,37318,0.31601372,0.627873948,-11638,11638,-0.311860228,0.311860228
Kentucky,KY,Magoffin County,21,153,21153,Bengals,#fb4f14,12808,1172,3824,5113,0.229219636,0.747897516,-2652,2652,-0.51867788,0.51867788
Kentucky,KY,Marion County,21,155,21155,Cowboys,#002244,19365,2679,5122,8108,0.330414406,0.631721756,-2443,2443,-0.301307351,0.301307351
Kentucky,KY,Marshall County,21,157,21157,Steelers,#ffb612,31101,3672,12322,16678,0.220170284,0.738817604,-8650,8650,-0.51864732,0.51864732
Kentucky,KY,Martin County,21,159,21159,Steelers,#ffb612,12307,363,3503,3951,0.091875475,0.886610985,-3140,3140,-0.79473551,0.79473551
Kentucky,KY,Mason County,21,161,21161,Bengals,#fb4f14,17099,1970,4944,7212,0.273155851,0.685524126,-2974,2974,-0.412368275,0.412368275
Kentucky,KY,Meade County,21,163,21163,Cowboys,#002244,27924,3026,8660,12223,0.247566064,0.708500368,-5634,5634,-0.460934304,0.460934304
Kentucky,KY,Menifee County,21,165,21165,Bengals,#fb4f14,6358,700,2010,2779,0.251889169,0.723281756,-1310,1310,-0.471392587,0.471392587
Kentucky,KY,Mercer County,21,167,21167,Bengals,#fb4f14,21407,2395,7740,10579,0.226391908,0.731638151,-5345,5345,-0.505246243,0.505246243
Kentucky,KY,Metcalfe County,21,169,21169,Cowboys,#002244,9909,976,3491,4616,0.211438475,0.756282496,-2515,2515,-0.544844021,0.544844021
Kentucky,KY,Monroe County,21,171,21171,Titans,#c60c30,10667,601,4278,4991,0.12041675,0.857142857,-3677,3677,-0.736726107,0.736726107
Kentucky,KY,Montgomery County,21,173,21173,Bengals,#fb4f14,27608,3158,7856,11437,0.27612136,0.686893416,-4698,4698,-0.410772056,0.410772056
Kentucky,KY,Morgan County,21,175,21175,Bengals,#fb4f14,13275,1006,3628,4766,0.211078473,0.761225346,-2622,2622,-0.550146874,0.550146874
Kentucky,KY,Muhlenberg County,21,177,21177,Titans,#c60c30,31183,3272,9393,13046,0.250804844,0.719990802,-6121,6121,-0.469185957,0.469185957
Kentucky,KY,Nelson County,21,179,21179,Cowboys,#002244,45126,6434,13430,20761,0.309908001,0.646885988,-6996,6996,-0.336977988,0.336977988
Kentucky,KY,Nicholas County,21,181,21181,Bengals,#fb4f14,7131,787,1957,2837,0.27740571,0.689813183,-1170,1170,-0.412407473,0.412407473
Kentucky,KY,Ohio County,21,183,21183,Colts,#002c5f,24216,2080,7942,10398,0.200038469,0.763800731,-5862,5862,-0.563762262,0.563762262
Kentucky,KY,Oldham County,21,185,21185,Colts,#002c5f,64875,10268,20469,32838,0.312686522,0.623332724,-10201,10201,-0.310646203,0.310646203
Kentucky,KY,Owen County,21,187,21187,Bengals,#fb4f14,10730,1062,3745,4997,0.212527517,0.74944967,-2683,2683,-0.536922153,0.536922153
Kentucky,KY,Owsley County,21,189,21189,Bengals,#fb4f14,4461,256,1474,1757,0.145702903,0.838929994,-1218,1218,-0.693227092,0.693227092
Kentucky,KY,Pendleton County,21,191,21191,Bengals,#fb4f14,14408,1164,4604,6006,0.193806194,0.766566767,-3440,3440,-0.572760573,0.572760573
Kentucky,KY,Perry County,21,193,21193,Bengals,#fb4f14,27565,2136,8158,10566,0.202157865,0.772099186,-6022,6022,-0.569941321,0.569941321
Kentucky,KY,Pike County,21,195,21195,Steelers,#ffb612,61792,4277,19740,24637,0.173600682,0.801233916,-15463,15463,-0.627633235,0.627633235
Kentucky,KY,Powell County,21,197,21197,Bengals,#fb4f14,12269,1272,3513,4952,0.256865913,0.709410339,-2241,2241,-0.452544426,0.452544426
Kentucky,KY,Pulaski County,21,199,21199,Bengals,#fb4f14,63782,4208,22900,28015,0.150205247,0.81741924,-18692,18692,-0.667213993,0.667213993
Kentucky,KY,Robertson County,21,201,21201,Bengals,#fb4f14,2138,222,759,1013,0.219151037,0.749259625,-537,537,-0.530108588,0.530108588
Kentucky,KY,Rockcastle County,21,203,21203,Bengals,#fb4f14,16942,915,5609,6686,0.136853126,0.83891714,-4694,4694,-0.702064014,0.702064014
Kentucky,KY,Rowan County,21,205,21205,Bengals,#fb4f14,23892,3295,5174,8829,0.373201948,0.586023332,-1879,1879,-0.212821384,0.212821384
Kentucky,KY,Russell County,21,207,21207,Colts,#002c5f,17662,1093,6863,8171,0.133765757,0.839921674,-5770,5770,-0.706155917,0.706155917
Kentucky,KY,Scott County,21,209,21209,Bengals,#fb4f14,52420,7713,15052,24159,0.319259903,0.623039033,-7339,7339,-0.30377913,0.30377913
Kentucky,KY,Shelby County,21,211,21211,Steelers,#ffb612,45632,6276,13196,20563,0.305208384,0.641735155,-6920,6920,-0.336526771,0.336526771
Kentucky,KY,Simpson County,21,213,21213,Titans,#c60c30,18006,2144,5077,7524,0.284954811,0.674774056,-2933,2933,-0.389819245,0.389819245
Kentucky,KY,Spencer County,21,215,21215,Colts,#002c5f,17894,1921,7196,9509,0.20201914,0.756756757,-5275,5275,-0.554737617,0.554737617
Kentucky,KY,Taylor County,21,217,21217,Cowboys,#002244,25420,2553,8320,11301,0.225909212,0.736218034,-5767,5767,-0.510308822,0.510308822
Kentucky,KY,Todd County,21,219,21219,Titans,#c60c30,12531,1042,3612,4771,0.218402851,0.757073989,-2570,2570,-0.538671138,0.538671138
Kentucky,KY,Trigg County,21,221,21221,Titans,#c60c30,14233,1587,4928,6740,0.235459941,0.73115727,-3341,3341,-0.495697329,0.495697329
Kentucky,KY,Trimble County,21,223,21223,Bengals,#fb4f14,8769,879,2771,3786,0.232171157,0.731907026,-1892,1892,-0.499735869,0.499735869
Kentucky,KY,Union County,21,225,21225,Colts,#002c5f,15050,1331,4701,6209,0.214366243,0.757126751,-3370,3370,-0.542760509,0.542760509
Kentucky,KY,Warren County,21,227,21227,Titans,#c60c30,122851,16966,28673,48416,0.350421348,0.59222158,-11707,11707,-0.241800231,0.241800231
Kentucky,KY,Washington County,21,229,21229,Cowboys,#002244,12063,1420,4013,5621,0.252624088,0.713929906,-2593,2593,-0.461305817,0.461305817
Kentucky,KY,Wayne County,21,231,21231,Steelers,#ffb612,20464,1431,6370,7988,0.179143716,0.797446169,-4939,4939,-0.618302454,0.618302454
Kentucky,KY,Webster County,21,233,21233,Colts,#002c5f,13170,1240,4397,5804,0.213645762,0.757580979,-3157,3157,-0.543935217,0.543935217
Kentucky,KY,Whitley County,21,235,21235,Bengals,#fb4f14,36129,2067,11312,13765,0.150163458,0.821794406,-9245,9245,-0.671630948,0.671630948
Kentucky,KY,Wolfe County,21,237,21237,Bengals,#fb4f14,7259,753,1804,2634,0.285876993,0.684889901,-1051,1051,-0.399012908,0.399012908
Kentucky,KY,Woodford County,21,239,21239,Bengals,#fb4f14,25793,4958,7697,13547,0.365985089,0.568170075,-2739,2739,-0.202184986,0.202184986
Louisiana,LA,Acadia Parish,22,1,22001,Saints,#9f8958,62577,5638,21159,27386,0.205871613,0.772621047,-15521,15521,-0.566749434,0.566749434
Louisiana,LA,Allen Parish,22,3,22003,Saints,#9f8958,25683,2106,6867,9245,0.22779881,0.742779881,-4761,4761,-0.514981071,0.514981071
Louisiana,LA,Ascension Parish,22,5,22005,Saints,#9f8958,119455,16471,36135,54663,0.301318991,0.661050436,-19664,19664,-0.359731445,0.359731445
Louisiana,LA,Assumption Parish,22,7,22007,Saints,#9f8958,22842,3931,6714,10904,0.360509905,0.615737344,-2783,2783,-0.255227439,0.255227439
Louisiana,LA,Avoyelles Parish,22,9,22009,Saints,#9f8958,41103,5032,11163,16581,0.303479887,0.673240456,-6131,6131,-0.369760569,0.369760569
Louisiana,LA,Beauregard Parish,22,11,22011,Saints,#9f8958,36462,2393,12238,15078,0.158708051,0.811646107,-9845,9845,-0.652938055,0.652938055
Louisiana,LA,Bienville Parish,22,13,22013,Saints,#9f8958,13786,3129,3756,7005,0.446680942,0.536188437,-627,627,-0.089507495,0.089507495
Louisiana,LA,Bossier Parish,22,15,22015,Saints,#9f8958,125175,12638,35451,49818,0.253683408,0.711610261,-22813,22813,-0.457926854,0.457926854
Louisiana,LA,Caddo Parish,22,17,22017,Saints,#9f8958,251460,53448,48977,105737,0.505480579,0.463196421,4471,-4471,0.042284158,-0.042284158
Louisiana,LA,Calcasieu Parish,22,19,22019,Saints,#9f8958,198788,26293,54182,83773,0.313860074,0.646771633,-27889,27889,-0.332911559,0.332911559
Louisiana,LA,Caldwell Parish,22,21,22021,Saints,#9f8958,9993,788,3822,4692,0.167945439,0.814578005,-3034,3034,-0.646632566,0.646632566
Louisiana,LA,Cameron Parish,22,23,22023,Saints,#9f8958,6817,323,3256,3692,0.087486457,0.881906826,-2933,2933,-0.794420368,0.794420368
Louisiana,LA,Catahoula Parish,22,25,22025,Saints,#9f8958,10147,1322,3479,4856,0.272240527,0.716433278,-2157,2157,-0.444192751,0.444192751
Louisiana,LA,Claiborne Parish,22,27,22027,Saints,#9f8958,16295,2717,3585,6421,0.423142813,0.558324249,-868,868,-0.135181436,0.135181436
Louisiana,LA,Concordia Parish,22,29,22029,Saints,#9f8958,20142,3272,5474,8869,0.368925471,0.617205998,-2202,2202,-0.248280528,0.248280528
Louisiana,LA,De Soto Parish,22,31,22031,Saints,#9f8958,27052,5163,8067,13497,0.382529451,0.597688375,-2904,2904,-0.215158924,0.215158924
Louisiana,LA,East Baton Rouge Parish,22,33,22033,Saints,#9f8958,446753,102711,84620,196332,0.523149563,0.431004625,18091,-18091,0.092144938,-0.092144938
Louisiana,LA,East Carroll Parish,22,35,22035,Saints,#9f8958,7307,1838,1059,2939,0.625382783,0.360326642,779,-779,0.265056142,-0.265056142
Louisiana,LA,East Feliciana Parish,22,37,22037,Saints,#9f8958,19696,4235,5569,10042,0.421728739,0.554570803,-1334,1334,-0.132842063,0.132842063
Louisiana,LA,Evangeline Parish,22,39,22039,Saints,#9f8958,33743,4208,10357,14879,0.282814705,0.696081726,-6149,6149,-0.413267021,0.413267021
Louisiana,LA,Franklin Parish,22,41,22041,Saints,#9f8958,20410,2506,6514,9162,0.273521065,0.710980135,-4008,4008,-0.43745907,0.43745907
Louisiana,LA,Grant Parish,22,43,22043,Saints,#9f8958,22343,1181,7406,8819,0.13391541,0.839777753,-6225,6225,-0.705862343,0.705862343
Louisiana,LA,Iberia Parish,22,45,22045,Saints,#9f8958,74103,10698,20903,32454,0.329635792,0.644080853,-10205,10205,-0.314445061,0.314445061
Louisiana,LA,Iberville Parish,22,47,22047,Saints,#9f8958,33095,8324,7320,16043,0.518855576,0.456273764,1004,-1004,0.062581811,-0.062581811
Louisiana,LA,Jackson Parish,22,49,22049,Saints,#9f8958,15858,2139,5169,7464,0.286575563,0.692524116,-3030,3030,-0.405948553,0.405948553
Louisiana,LA,Jefferson Parish,22,51,22051,Saints,#9f8958,436275,73540,100292,181388,0.405429246,0.552914195,-26752,26752,-0.147484949,0.147484949
Louisiana,LA,Jefferson Davis Parish,22,53,22053,Saints,#9f8958,31439,3080,10775,14277,0.215731596,0.754710373,-7695,7695,-0.538978777,0.538978777
Louisiana,LA,Lafayette Parish,22,55,22055,Saints,#9f8958,240098,32726,68191,105599,0.309908238,0.645754221,-35465,35465,-0.335845983,0.335845983
Louisiana,LA,Lafourche Parish,22,57,22057,Saints,#9f8958,98325,8423,31958,41644,0.202262031,0.767409471,-23535,23535,-0.56514744,0.56514744
Louisiana,LA,La Salle Parish,22,59,22059,Saints,#9f8958,14974,605,5835,6568,0.092113276,0.888398295,-5230,5230,-0.796285018,0.796285018
Louisiana,LA,Lincoln Parish,22,61,22061,Saints,#9f8958,47774,7102,10761,18664,0.380518646,0.576564509,-3659,3659,-0.196045864,0.196045864
Louisiana,LA,Livingston Parish,22,63,22063,Saints,#9f8958,137788,6950,48797,57700,0.120450607,0.845701906,-41847,41847,-0.7252513,0.7252513
Louisiana,LA,Madison Parish,22,65,22065,Saints,#9f8958,11514,2744,1927,4732,0.579881657,0.407227388,817,-817,0.172654269,-0.172654269
Louisiana,LA,Morehouse Parish,22,67,22067,Saints,#9f8958,26395,5155,6502,11852,0.434947688,0.548599393,-1347,1347,-0.113651704,0.113651704
Louisiana,LA,Natchitoches Parish,22,69,22069,Saints,#9f8958,39179,7143,8965,16617,0.429860986,0.539507733,-1822,1822,-0.109646747,0.109646747
Louisiana,LA,Orleans Parish,22,71,22071,Saints,#9f8958,389617,133833,24267,165619,0.808077576,0.146523044,109566,-109566,0.661554532,-0.661554532
Louisiana,LA,Ouachita Parish,22,73,22073,Saints,#9f8958,156761,24420,41712,67987,0.359186315,0.613529057,-17292,17292,-0.254342742,0.254342742
Louisiana,LA,Plaquemines Parish,22,75,22075,Saints,#9f8958,23495,3347,6900,10572,0.316590995,0.652667423,-3553,3553,-0.336076428,0.336076428
Louisiana,LA,Pointe Coupee Parish,22,77,22077,Saints,#9f8958,22251,4764,6789,11761,0.405067596,0.577246833,-2025,2025,-0.172179236,0.172179236
Louisiana,LA,Rapides Parish,22,79,22079,Saints,#9f8958,132141,18318,36814,56838,0.322284387,0.647700482,-18496,18496,-0.325416095,0.325416095
Louisiana,LA,Red River Parish,22,81,22081,Saints,#9f8958,8593,1938,2391,4422,0.438263229,0.540705563,-453,453,-0.102442334,0.102442334
Louisiana,LA,Richland Parish,22,83,22083,Saints,#9f8958,20523,3157,6286,9596,0.328991246,0.65506461,-3129,3129,-0.326073364,0.326073364
Louisiana,LA,Sabine Parish,22,85,22085,Saints,#9f8958,24186,1703,7877,9785,0.174041901,0.805007665,-6174,6174,-0.630965764,0.630965764
Louisiana,LA,St. Bernard Parish,22,87,22087,Saints,#9f8958,45408,4957,10232,15807,0.313595243,0.647308155,-5275,5275,-0.333712912,0.333712912
Louisiana,LA,St. Charles Parish,22,89,22089,Saints,#9f8958,52812,8558,16620,26190,0.326765941,0.634593356,-8062,8062,-0.307827415,0.307827415
Louisiana,LA,St. Helena Parish,22,91,22091,Saints,#9f8958,10567,3353,2497,5964,0.562206573,0.418678739,856,-856,0.143527834,-0.143527834
Louisiana,LA,St. James Parish,22,93,22093,Saints,#9f8958,21567,6418,5456,12085,0.531071576,0.451468763,962,-962,0.079602813,-0.079602813
Louisiana,LA,St. John the Baptist Parish,22,95,22095,Saints,#9f8958,43626,12658,7569,20740,0.610318226,0.364946962,5089,-5089,0.245371263,-0.245371263
Louisiana,LA,St. Landry Parish,22,97,22097,Saints,#9f8958,83848,17208,21966,39970,0.430522892,0.549562172,-4758,4758,-0.119039279,0.119039279
Louisiana,LA,St. Martin Parish,22,99,22099,Saints,#9f8958,53835,8266,16872,25749,0.321022176,0.655248748,-8606,8606,-0.334226572,0.334226572
Louisiana,LA,St. Mary Parish,22,101,22101,Saints,#9f8958,52810,8050,14353,22871,0.351974116,0.62756329,-6303,6303,-0.275589174,0.275589174
Louisiana,LA,St. Tammany Parish,22,103,22103,Saints,#9f8958,250088,27716,90914,124389,0.22281713,0.730884564,-63198,63198,-0.508067434,0.508067434
Louisiana,LA,Tangipahoa Parish,22,105,22105,Saints,#9f8958,128755,16869,33933,52381,0.322044253,0.647811229,-17064,17064,-0.325766977,0.325766977
Louisiana,LA,Tensas Parish,22,107,22107,Saints,#9f8958,4740,1329,1180,2543,0.522611089,0.464018875,149,-149,0.058592214,-0.058592214
Louisiana,LA,Terrebonne Parish,22,109,22109,Saints,#9f8958,113972,10664,31900,43893,0.242954457,0.726767366,-21236,21236,-0.483812909,0.483812909
Louisiana,LA,Union Parish,22,111,22111,Saints,#9f8958,22477,2691,7972,10894,0.247016706,0.731778961,-5281,5281,-0.484762254,0.484762254
Louisiana,LA,Vermilion Parish,22,113,22113,Saints,#9f8958,59875,4745,19807,25253,0.187898468,0.784342454,-15062,15062,-0.596443987,0.596443987
Louisiana,LA,Vernon Parish,22,115,22115,Saints,#9f8958,50803,2665,13471,16633,0.160223652,0.80989599,-10806,10806,-0.649672338,0.649672338
Louisiana,LA,Washington Parish,22,117,22117,Saints,#9f8958,46371,5690,12552,18622,0.305552572,0.674041456,-6862,6862,-0.368488884,0.368488884
Louisiana,LA,Webster Parish,22,119,22119,Saints,#9f8958,40021,6259,11538,18140,0.345038589,0.636052922,-5279,5279,-0.291014333,0.291014333
Louisiana,LA,West Baton Rouge Parish,22,121,22121,Saints,#9f8958,25490,5382,6926,12710,0.423446105,0.544925256,-1544,1544,-0.12147915,0.12147915
Louisiana,LA,West Carroll Parish,22,123,22123,Saints,#9f8958,11293,715,3970,4759,0.150241647,0.834208867,-3255,3255,-0.68396722,0.68396722
Louisiana,LA,West Feliciana Parish,22,125,22125,Saints,#9f8958,15385,2247,3390,5798,0.38754743,0.584684374,-1143,1143,-0.197136944,0.197136944
Louisiana,LA,Winn Parish,22,127,22127,Saints,#9f8958,14568,1643,4605,6368,0.258008794,0.723146985,-2962,2962,-0.465138191,0.465138191
Maine,ME,Androscoggin County,23,1,23001,Patriots,#c60c30,107233,22975,28189,55340,0.415160824,0.509378388,-5214,5214,-0.094217564,0.094217564
Maine,ME,Aroostook County,23,3,23003,Patriots,#c60c30,68628,13377,19419,34963,0.382604468,0.555415725,-6042,6042,-0.172811258,0.172811258
Maine,ME,Cumberland County,23,5,23005,Patriots,#c60c30,289977,102935,57697,171249,0.601083802,0.336918756,45238,-45238,0.264165046,-0.264165046
Maine,ME,Franklin County,23,7,23007,Patriots,#c60c30,29991,7001,7900,16382,0.427359297,0.482236601,-899,899,-0.054877304,0.054877304
Maine,ME,Hancock County,23,9,23009,Patriots,#c60c30,54659,16107,13682,31983,0.503611293,0.427789763,2425,-2425,0.07582153,-0.07582153
Maine,ME,Kennebec County,23,11,23011,Patriots,#c60c30,119980,29296,31753,65999,0.443885513,0.48111335,-2457,2457,-0.037227837,0.037227837
Maine,ME,Knox County,23,13,23013,Patriots,#c60c30,39855,12440,9148,23021,0.540376178,0.397376309,3292,-3292,0.14299987,-0.14299987
Maine,ME,Lincoln County,23,15,23015,Patriots,#c60c30,33969,10241,9727,21432,0.477836879,0.45385405,514,-514,0.023982829,-0.023982829
Maine,ME,Oxford County,23,17,23017,Patriots,#c60c30,57202,12172,16214,31094,0.391458159,0.521451084,-4042,4042,-0.129992925,0.129992925
Maine,ME,Penobscot County,23,19,23019,Patriots,#c60c30,152692,32832,41601,80228,0.409233684,0.518534676,-8769,8769,-0.109300992,0.109300992
Maine,ME,Piscataquis County,23,21,23021,Patriots,#c60c30,16931,3098,5403,9144,0.3388014,0.590879265,-2305,2305,-0.252077865,0.252077865
Maine,ME,Sagadahoc County,23,23,23023,Patriots,#c60c30,35149,10679,9304,21596,0.49448972,0.430820522,1375,-1375,0.063669198,-0.063669198
Maine,ME,Somerset County,23,25,23025,Patriots,#c60c30,51113,9092,14998,25968,0.350123229,0.577556993,-5906,5906,-0.227433765,0.227433765
Maine,ME,Waldo County,23,27,23027,Patriots,#c60c30,39155,10442,10378,22630,0.46142289,0.458594786,64,-64,0.002828104,-0.002828104
Maine,ME,Washington County,23,29,23029,Patriots,#c60c30,31625,6358,9037,16559,0.383960384,0.545745516,-2679,2679,-0.161785132,0.161785132
Maine,ME,York County,23,31,23031,Patriots,#c60c30,201169,55828,50388,113962,0.489882592,0.442147382,5440,-5440,0.04773521,-0.04773521
Maryland,MD,Allegany County,24,1,24001,Ravens,#241773,72528,6665,20025,27804,0.23971371,0.720220112,-13360,13360,-0.480506402,0.480506402
Maryland,MD,Anne Arundel County,24,3,24003,Ravens,#241773,564195,116074,114509,242939,0.477790721,0.471348775,1565,-1565,0.006441946,-0.006441946
Maryland,MD,Baltimore County,24,5,24005,Ravens,#241773,831128,189437,131009,335017,0.565454887,0.391051797,58428,-58428,0.17440309,-0.17440309
Maryland,MD,Calvert County,24,9,24009,Redskins,#773141,90595,16669,24680,43445,0.383680516,0.568074577,-8011,8011,-0.184394061,0.184394061
Maryland,MD,Caroline County,24,11,24011,Ravens,#241773,32579,3747,8999,13282,0.282111128,0.677533504,-5252,5252,-0.395422376,0.395422376
Maryland,MD,Carroll County,24,13,24013,Ravens,#241773,167627,24314,55593,84879,0.286454836,0.65496766,-31279,31279,-0.368512824,0.368512824
Maryland,MD,Cecil County,24,15,24015,Ravens,#241773,102382,12651,27579,42309,0.299014394,0.651847125,-14928,14928,-0.352832731,0.352832731
Maryland,MD,Charles County,24,17,24017,Redskins,#773141,156118,46063,24163,72480,0.635527042,0.333374724,21900,-21900,0.302152318,-0.302152318
Maryland,MD,Dorchester County,24,19,24019,Ravens,#241773,32384,5695,7938,14034,0.4058002,0.565626336,-2243,2243,-0.159826137,0.159826137
Maryland,MD,Frederick County,24,21,24021,Redskins,#773141,245322,51891,56472,114962,0.451375237,0.491223187,-4581,4581,-0.03984795,0.03984795
Maryland,MD,Garrett County,24,23,24023,Steelers,#ffb612,29460,2252,10189,12905,0.174506005,0.789538938,-7937,7937,-0.615032933,0.615032933
Maryland,MD,Harford County,24,25,24025,Ravens,#241773,250290,43803,74261,124224,0.352613022,0.597799137,-30458,30458,-0.245186115,0.245186115
Maryland,MD,Howard County,24,27,24027,Ravens,#241773,313414,93808,44792,146401,0.640760651,0.305954194,49016,-49016,0.334806456,-0.334806456
Maryland,MD,Kent County,24,29,24029,Ravens,#241773,19787,4178,4598,9166,0.455814968,0.501636483,-420,420,-0.045821514,0.045821514
Maryland,MD,Montgomery County,24,31,24031,Redskins,#773141,1040116,309761,82985,408300,0.758660299,0.203245163,226776,-226776,0.555415136,-0.555415136
Maryland,MD,Prince George's County,24,33,24033,Redskins,#773141,909535,313627,29290,351091,0.893292622,0.083425665,284337,-284337,0.809866958,-0.809866958
Maryland,MD,Queen Anne's County,24,35,24035,Ravens,#241773,48904,7316,16211,24633,0.296999959,0.658100922,-8895,8895,-0.361100962,0.361100962
Maryland,MD,St. Mary's County,24,37,24037,Redskins,#773141,111413,15786,26889,45169,0.34948748,0.59529766,-11103,11103,-0.24581018,0.24581018
Maryland,MD,Somerset County,24,39,24039,Ravens,#241773,25768,3484,5056,8768,0.397354015,0.576642336,-1572,1572,-0.179288321,0.179288321
Maryland,MD,Talbot County,24,41,24041,Ravens,#241773,37512,7865,10098,18731,0.419892157,0.539106294,-2233,2233,-0.119214137,0.119214137
Maryland,MD,Washington County,24,43,24043,Ravens,#241773,149585,19193,38842,60731,0.316032998,0.639574517,-19649,19649,-0.323541519,0.323541519
Maryland,MD,Wicomico County,24,45,24045,Ravens,#241773,102370,16327,20832,38722,0.421646609,0.53798874,-4505,4505,-0.116342131,0.116342131
Maryland,MD,Worcester County,24,47,24047,Ravens,#241773,51540,8783,15910,25571,0.34347503,0.622189199,-7127,7127,-0.278714168,0.278714168
Maryland,MD,Baltimore city,24,510,24510,Ravens,#241773,621849,178562,22726,208980,0.854445401,0.108747249,155836,-155836,0.745698153,-0.745698153
Massachusetts,MA,Barnstable County,25,1,25001,Patriots,#c60c30,214333,71632,53842,132667,0.539938342,0.405843201,17790,-17790,0.13409514,-0.13409514
Massachusetts,MA,Berkshire County,25,3,25003,Patriots,#c60c30,127828,43540,16799,64507,0.674965508,0.26042135,26741,-26741,0.414544158,-0.414544158
Massachusetts,MA,Bristol County,25,5,25005,Patriots,#c60c30,556772,127619,104775,246068,0.518633061,0.425796934,22844,-22844,0.092836127,-0.092836127
Massachusetts,MA,Dukes County,25,7,25007,Patriots,#c60c30,17299,8338,2474,11434,0.729228616,0.216372223,5864,-5864,0.512856393,-0.512856393
Massachusetts,MA,Essex County,25,9,25009,Patriots,#c60c30,776043,220027,135405,376140,0.584960387,0.359985644,84622,-84622,0.224974743,-0.224974743
Massachusetts,MA,Franklin County,25,11,25011,Patriots,#c60c30,70601,24369,10327,37987,0.641508937,0.271856161,14042,-14042,0.369652776,-0.369652776
Massachusetts,MA,Hampden County,25,13,25013,Patriots,#c60c30,470690,110313,78230,200220,0.550958945,0.390720208,32083,-32083,0.160238737,-0.160238737
Massachusetts,MA,Hampshire County,25,15,25015,Patriots,#c60c30,161292,54572,22089,82329,0.662852701,0.268301571,32483,-32483,0.39455113,-0.39455113
Massachusetts,MA,Middlesex County,25,17,25017,Patriots,#c60c30,1585139,508919,216163,767337,0.6632275,0.281705431,292756,-292756,0.381522069,-0.381522069
Massachusetts,MA,Nantucket County,25,19,25019,Patriots,#c60c30,10925,4144,1892,6404,0.647095565,0.29544035,2252,-2252,0.351655215,-0.351655215
Massachusetts,MA,Norfolk County,25,21,25021,Patriots,#c60c30,696023,219129,119171,357781,0.612466844,0.333083646,99958,-99958,0.279383198,-0.279383198
Massachusetts,MA,Plymouth County,25,23,25023,Patriots,#c60c30,510393,133828,114722,264168,0.506601859,0.434276672,19106,-19106,0.072325187,-0.072325187
Massachusetts,MA,Suffolk County,25,25,25025,Patriots,#c60c30,778121,241212,50042,303517,0.794723195,0.164873796,191170,-191170,0.629849399,-0.629849399
Massachusetts,MA,Worcester County,25,27,25027,Patriots,#c60c30,818963,197126,157138,380972,0.517429102,0.412466008,39988,-39988,0.104963094,-0.104963094
Michigan,MI,Alcona County,26,1,26001,Lions,#005a8b,10349,1732,4201,6179,0.280304256,0.679883476,-2469,2469,-0.39957922,0.39957922
Michigan,MI,Alger County,26,3,26003,Lions,#005a8b,9383,1663,2585,4513,0.368491026,0.572789719,-922,922,-0.204298693,0.204298693
Michigan,MI,Allegan County,26,5,26005,Lions,#005a8b,114625,17932,33812,55153,0.325131906,0.61305822,-15880,15880,-0.287926314,0.287926314
Michigan,MI,Alpena County,26,7,26007,Lions,#005a8b,28803,4877,9090,14688,0.33203976,0.618872549,-4213,4213,-0.286832789,0.286832789
Michigan,MI,Antrim County,26,9,26009,Lions,#005a8b,23154,4448,8469,13572,0.327733569,0.624005305,-4021,4021,-0.296271736,0.296271736
Michigan,MI,Arenac County,26,11,26011,Lions,#005a8b,15261,2238,4704,7457,0.300120692,0.630816682,-2466,2466,-0.33069599,0.33069599
Michigan,MI,Baraga County,26,13,26013,Packers,#203731,8575,1156,2158,3486,0.331612163,0.619047619,-1002,1002,-0.287435456,0.287435456
Michigan,MI,Barry County,26,15,26015,Lions,#005a8b,59314,9109,19197,30265,0.300974723,0.634297043,-10088,10088,-0.33332232,0.33332232
Michigan,MI,Bay County,26,17,26017,Lions,#005a8b,105659,21641,28327,52932,0.408845311,0.535158316,-6686,6686,-0.126313005,0.126313005
Michigan,MI,Benzie County,26,19,26019,Lions,#005a8b,17457,4108,5539,10221,0.401917621,0.541923491,-1431,1431,-0.14000587,0.14000587
Michigan,MI,Berrien County,26,21,26021,Bears,#c83803,154636,29496,38646,71882,0.410339167,0.537631118,-9150,9150,-0.127291951,0.127291951
Michigan,MI,Branch County,26,23,26023,Lions,#005a8b,43664,4740,11025,16490,0.287446938,0.668587022,-6285,6285,-0.381140085,0.381140085
Michigan,MI,Calhoun County,26,25,26025,Lions,#005a8b,134314,24154,31489,58786,0.410880142,0.535654748,-7335,7335,-0.124774606,0.124774606
Michigan,MI,Cass County,26,27,26027,Bears,#c83803,51657,7270,14241,23272,0.312392575,0.611937092,-6971,6971,-0.299544517,0.299544517
Michigan,MI,Charlevoix County,26,29,26029,Lions,#005a8b,26238,5137,8674,14567,0.352646393,0.595455482,-3537,3537,-0.242809089,0.242809089
Michigan,MI,Cheboygan County,26,31,26031,Lions,#005a8b,25427,4302,8680,13647,0.315234117,0.636037224,-4378,4378,-0.320803107,0.320803107
Michigan,MI,Chippewa County,26,33,26033,Lions,#005a8b,38033,5378,9120,15434,0.348451471,0.590903201,-3742,3742,-0.24245173,0.24245173
Michigan,MI,Clare County,26,35,26035,Lions,#005a8b,30553,4250,8507,13385,0.317519612,0.635562196,-4257,4257,-0.318042585,0.318042585
Michigan,MI,Clinton County,26,37,26037,Lions,#005a8b,77390,16490,21635,40564,0.406518095,0.533354699,-5145,5145,-0.126836604,0.126836604
Michigan,MI,Crawford County,26,39,26039,Lions,#005a8b,13801,2110,4354,6833,0.308795551,0.637201815,-2244,2244,-0.328406264,0.328406264
Michigan,MI,Delta County,26,41,26041,Packers,#203731,36377,6431,11112,18467,0.348242812,0.601721991,-4681,4681,-0.253479179,0.253479179
Michigan,MI,Dickinson County,26,43,26043,Packers,#203731,25788,3923,8580,13140,0.298554033,0.652968037,-4657,4657,-0.354414003,0.354414003
Michigan,MI,Eaton County,26,45,26045,Lions,#005a8b,108801,24534,27608,55686,0.440577524,0.495779909,-3074,3074,-0.055202385,0.055202385
Michigan,MI,Emmet County,26,47,26047,Lions,#005a8b,33161,6972,10616,18774,0.371364653,0.565462874,-3644,3644,-0.194098221,0.194098221
Michigan,MI,Genesee County,26,49,26049,Lions,#005a8b,410849,102744,84174,196135,0.523843271,0.429163586,18570,-18570,0.094679685,-0.094679685
Michigan,MI,Gladwin County,26,51,26051,Lions,#005a8b,25164,3794,8124,12472,0.304201411,0.651379089,-4330,4330,-0.347177678,0.347177678
Michigan,MI,Gogebic County,26,53,26053,Packers,#203731,15431,2925,4019,7313,0.399972651,0.54956926,-1094,1094,-0.149596609,0.149596609
Michigan,MI,Grand Traverse County,26,55,26055,Lions,#005a8b,91636,20964,27412,51460,0.407384376,0.532685581,-6448,6448,-0.125301205,0.125301205
Michigan,MI,Gratiot County,26,57,26057,Lions,#005a8b,41540,5665,9878,16442,0.344544459,0.600778494,-4213,4213,-0.256234035,0.256234035
Michigan,MI,Hillsdale County,26,59,26059,Lions,#005a8b,45941,4799,14094,19880,0.24139839,0.708953722,-9295,9295,-0.467555332,0.467555332
Michigan,MI,Houghton County,26,61,26061,Packers,#203731,36380,6018,8475,15623,0.385201306,0.542469436,-2457,2457,-0.15726813,0.15726813
Michigan,MI,Huron County,26,63,26063,Lions,#005a8b,31883,4579,10629,15848,0.288932357,0.670683998,-6050,6050,-0.381751641,0.381751641
Michigan,MI,Ingham County,26,65,26065,Lions,#005a8b,286085,81266,44354,133478,0.608834415,0.332294461,36912,-36912,0.276539954,-0.276539954
Michigan,MI,Ionia County,26,67,26067,Lions,#005a8b,64223,8206,16374,26364,0.311257776,0.621074192,-8168,8168,-0.309816416,0.309816416
Michigan,MI,Iosco County,26,69,26069,Lions,#005a8b,25345,4344,8344,13349,0.325417634,0.625065548,-4000,4000,-0.299647914,0.299647914
Michigan,MI,Iron County,26,71,26071,Packers,#203731,11348,2004,3675,5910,0.339086294,0.621827411,-1671,1671,-0.282741117,0.282741117
Michigan,MI,Isabella County,26,73,26073,Lions,#005a8b,70698,11404,12338,25344,0.449968434,0.486821338,-934,934,-0.036852904,0.036852904
Michigan,MI,Jackson County,26,75,26075,Lions,#005a8b,159494,25795,39793,69567,0.370793623,0.572009717,-13998,13998,-0.201216094,0.201216094
Michigan,MI,Kalamazoo County,26,77,26077,Lions,#005a8b,260263,67142,51031,125966,0.533016846,0.405117254,16111,-16111,0.127899592,-0.127899592
Michigan,MI,Kalkaska County,26,79,26079,Lions,#005a8b,17260,2279,6213,8920,0.255493274,0.696524664,-3934,3934,-0.44103139,0.44103139
Michigan,MI,Kent County,26,81,26081,Lions,#005a8b,636369,138567,147959,306270,0.452434127,0.483099879,-9392,9392,-0.030665752,0.030665752
Michigan,MI,Keweenaw County,26,83,26083,Packers,#203731,2168,527,814,1429,0.368789363,0.569629111,-287,287,-0.200839748,0.200839748
Michigan,MI,Lake County,26,85,26085,Lions,#005a8b,11424,1939,3159,5328,0.363926426,0.592905405,-1220,1220,-0.228978979,0.228978979
Michigan,MI,Lapeer County,26,87,26087,Lions,#005a8b,88373,12734,30037,45126,0.282187652,0.665625139,-17303,17303,-0.383437486,0.383437486
Michigan,MI,Leelanau County,26,89,26089,Lions,#005a8b,21981,6774,7239,14757,0.45903639,0.490546859,-465,465,-0.03151047,0.03151047
Michigan,MI,Lenawee County,26,91,26091,Lions,#005a8b,98573,16750,26428,45895,0.364963504,0.575836148,-9678,9678,-0.210872644,0.210872644
Michigan,MI,Livingston County,26,93,26093,Lions,#005a8b,187316,34378,65665,105577,0.325620163,0.621963117,-31287,31287,-0.296342953,0.296342953
Michigan,MI,Luce County,26,95,26095,Lions,#005a8b,6415,681,1756,2576,0.264363354,0.681677019,-1075,1075,-0.417313665,0.417313665
Michigan,MI,Mackinac County,26,97,26097,Lions,#005a8b,10890,2085,3740,6088,0.342477004,0.614323259,-1655,1655,-0.271846255,0.271846255
Michigan,MI,Macomb County,26,99,26099,Lions,#005a8b,864840,176238,224589,418773,0.420843751,0.536302484,-48351,48351,-0.115458733,0.115458733
Michigan,MI,Manistee County,26,101,26101,Lions,#005a8b,24461,4979,6915,12598,0.395221464,0.54889665,-1936,1936,-0.153675187,0.153675187
Michigan,MI,Marquette County,26,103,26103,Packers,#203731,67215,16042,14646,32897,0.48764325,0.44520777,1396,-1396,0.04243548,-0.04243548
Michigan,MI,Mason County,26,105,26105,Lions,#005a8b,28783,5281,8505,14658,0.360281075,0.580229226,-3224,3224,-0.219948151,0.219948151
Michigan,MI,Mecosta County,26,107,26107,Lions,#005a8b,43067,5827,10305,17149,0.339786576,0.600909674,-4478,4478,-0.261123098,0.261123098
Michigan,MI,Menominee County,26,109,26109,Packers,#203731,23548,3539,6704,10765,0.328750581,0.622758941,-3165,3165,-0.29400836,0.29400836
Michigan,MI,Midland County,26,111,26111,Lions,#005a8b,83632,15655,23877,42379,0.369404658,0.563415843,-8222,8222,-0.194011185,0.194011185
Michigan,MI,Missaukee County,26,113,26113,Lions,#005a8b,14903,1565,5386,7301,0.214354198,0.737707163,-3821,3821,-0.523352965,0.523352965
Michigan,MI,Monroe County,26,115,26115,Lions,#005a8b,149568,26859,43255,74101,0.362464744,0.583730314,-16396,16396,-0.22126557,0.22126557
Michigan,MI,Montcalm County,26,117,26117,Lions,#005a8b,62945,7874,16907,26556,0.296505498,0.636654617,-9033,9033,-0.340149119,0.340149119
Michigan,MI,Montmorency County,26,119,26119,Lions,#005a8b,9259,1286,3498,5008,0.256789137,0.698482428,-2212,2212,-0.441693291,0.441693291
Michigan,MI,Muskegon County,26,121,26121,Lions,#005a8b,172790,36640,35962,77114,0.475140701,0.466348523,678,-678,0.008792178,-0.008792178
Michigan,MI,Newaygo County,26,123,26123,Lions,#005a8b,47948,6212,15174,22605,0.274806459,0.671267419,-8962,8962,-0.39646096,0.39646096
Michigan,MI,Oakland County,26,125,26125,Lions,#005a8b,1242304,342976,289127,663255,0.517110312,0.435921327,53849,-53849,0.081188985,-0.081188985
Michigan,MI,Oceana County,26,127,26127,Lions,#005a8b,26105,3973,7228,11903,0.3337814,0.607241872,-3255,3255,-0.273460472,0.273460472
Michigan,MI,Ogemaw County,26,129,26129,Lions,#005a8b,20937,3030,6827,10386,0.291738879,0.657327171,-3797,3797,-0.365588292,0.365588292
Michigan,MI,Ontonagon County,26,131,26131,Packers,#203731,6007,1175,2069,3420,0.343567251,0.60497076,-894,894,-0.261403509,0.261403509
Michigan,MI,Osceola County,26,133,26133,Lions,#005a8b,23058,2705,7336,10597,0.255260923,0.692271398,-4631,4631,-0.437010475,0.437010475
Michigan,MI,Oscoda County,26,135,26135,Lions,#005a8b,8251,1044,2843,4062,0.257016248,0.699901526,-1799,1799,-0.442885278,0.442885278
Michigan,MI,Otsego County,26,137,26137,Lions,#005a8b,24253,3556,8266,12529,0.283821534,0.659749381,-4710,4710,-0.375927847,0.375927847
Michigan,MI,Ottawa County,26,139,26139,Lions,#005a8b,279955,46276,90456,145405,0.318255906,0.622096902,-44180,44180,-0.303840996,0.303840996
Michigan,MI,Presque Isle County,26,141,26141,Lions,#005a8b,12841,2400,4486,7215,0.332640333,0.621760222,-2086,2086,-0.289119889,0.289119889
Michigan,MI,Roscommon County,26,143,26143,Lions,#005a8b,23898,4287,8141,13036,0.328858546,0.624501381,-3854,3854,-0.295642835,0.295642835
Michigan,MI,Saginaw County,26,145,26145,Lions,#005a8b,193307,44395,45469,94198,0.471294507,0.482696023,-1074,1074,-0.011401516,0.011401516
Michigan,MI,St. Clair County,26,147,26147,Lions,#005a8b,159875,24553,49067,77994,0.314806267,0.629112496,-24514,24514,-0.314306229,0.314306229
Michigan,MI,St. Joseph County,26,149,26149,Lions,#005a8b,61018,7529,14886,23765,0.316810436,0.626383337,-7357,7357,-0.309572901,0.309572901
Michigan,MI,Sanilac County,26,151,26151,Lions,#005a8b,41475,4873,13446,19243,0.253234943,0.698747597,-8573,8573,-0.445512654,0.445512654
Michigan,MI,Schoolcraft County,26,153,26153,Lions,#005a8b,8173,1369,2556,4151,0.329800048,0.61575524,-1187,1187,-0.285955192,0.285955192
Michigan,MI,Shiawassee County,26,155,26155,Lions,#005a8b,68619,12547,19232,34044,0.368552462,0.564915991,-6685,6685,-0.19636353,0.19636353
Michigan,MI,Tuscola County,26,157,26157,Lions,#005a8b,53777,7493,17421,26157,0.286462515,0.666016745,-9928,9928,-0.37955423,0.37955423
Michigan,MI,Van Buren County,26,159,26159,Lions,#005a8b,75077,13258,17890,33213,0.399181044,0.538644507,-4632,4632,-0.139463463,0.139463463
Michigan,MI,Washtenaw County,26,161,26161,Lions,#005a8b,358880,128025,50335,187201,0.683890578,0.268882111,77690,-77690,0.415008467,-0.415008467
Michigan,MI,Wayne County,26,163,26163,Lions,#005a8b,1759335,517842,228908,775450,0.667795474,0.295193758,288934,-288934,0.372601715,-0.372601715
Michigan,MI,Wexford County,26,165,26165,Lions,#005a8b,33003,4436,10000,15279,0.290333137,0.654493095,-5564,5564,-0.364159958,0.364159958
Minnesota,MN,Aitkin County,27,1,27001,Vikings,#4f2683,15702,3134,5516,9185,0.341208492,0.600544366,-2382,2382,-0.259335874,0.259335874
Minnesota,MN,Anoka County,27,3,27003,Vikings,#4f2683,344151,75499,93341,184084,0.410133417,0.507056561,-17842,17842,-0.096923144,0.096923144
Minnesota,MN,Becker County,27,5,27005,Vikings,#4f2683,33386,5208,10880,17090,0.304739614,0.636629608,-5672,5672,-0.331889994,0.331889994
Minnesota,MN,Beltrami County,27,7,27007,Vikings,#4f2683,45672,8688,10783,21316,0.40758116,0.50586414,-2095,2095,-0.09828298,0.09828298
Minnesota,MN,Benton County,27,9,27009,Vikings,#4f2683,39710,5640,12872,19911,0.283260509,0.646476822,-7232,7232,-0.363216313,0.363216313
Minnesota,MN,Big Stone County,27,11,27011,Vikings,#4f2683,5040,921,1607,2729,0.337486259,0.588860388,-686,686,-0.25137413,0.25137413
Minnesota,MN,Blue Earth County,27,13,27013,Vikings,#4f2683,65787,14428,15667,33256,0.433846524,0.471102959,-1239,1239,-0.037256435,0.037256435
Minnesota,MN,Brown County,27,15,27015,Vikings,#4f2683,25313,3763,8708,13663,0.275415355,0.637341726,-4945,4945,-0.36192637,0.36192637
Minnesota,MN,Carlton County,27,17,27017,Vikings,#4f2683,35569,8460,8160,18059,0.468464478,0.451852262,300,-300,0.016612216,-0.016612216
Minnesota,MN,Carver County,27,19,27019,Vikings,#4f2683,98741,21508,29057,55102,0.39033066,0.527331131,-7549,7549,-0.137000472,0.137000472
Minnesota,MN,Cass County,27,21,27021,Vikings,#4f2683,28706,4949,9982,15885,0.311551778,0.628391564,-5033,5033,-0.316839786,0.316839786
Minnesota,MN,Chippewa County,27,23,27023,Vikings,#4f2683,12109,1978,3764,6182,0.319961178,0.608864445,-1786,1786,-0.288903268,0.288903268
Minnesota,MN,Chisago County,27,25,27025,Vikings,#4f2683,54293,9279,18441,30009,0.309207238,0.614515645,-9162,9162,-0.305308407,0.305308407
Minnesota,MN,Clay County,27,27,27027,Vikings,#4f2683,62324,12974,13549,29108,0.44571939,0.465473409,-575,575,-0.01975402,0.01975402
Minnesota,MN,Clearwater County,27,29,27029,Vikings,#4f2683,8803,1100,2925,4225,0.26035503,0.692307692,-1825,1825,-0.431952663,0.431952663
Minnesota,MN,Cook County,27,31,27031,Vikings,#4f2683,5194,1912,1156,3360,0.569047619,0.344047619,756,-756,0.225,-0.225
Minnesota,MN,Cottonwood County,27,33,27033,Vikings,#4f2683,11549,1678,3679,5697,0.294540986,0.64577848,-2001,2001,-0.351237493,0.351237493
Minnesota,MN,Crow Wing County,27,35,27035,Vikings,#4f2683,63428,10982,22287,35568,0.308760684,0.626602564,-11305,11305,-0.31784188,0.31784188
Minnesota,MN,Dakota County,27,37,27037,Vikings,#4f2683,414686,110251,99624,228659,0.482163396,0.435688077,10627,-10627,0.046475319,-0.046475319
Minnesota,MN,Dodge County,27,39,27039,Vikings,#4f2683,20364,3102,6527,10564,0.293638773,0.617853086,-3425,3425,-0.324214313,0.324214313
Minnesota,MN,Douglas County,27,41,27041,Vikings,#4f2683,37075,6227,13966,21623,0.287980391,0.645886325,-7739,7739,-0.357905933,0.357905933
Minnesota,MN,Faribault County,27,43,27043,Vikings,#4f2683,14050,2153,4659,7355,0.292726037,0.633446635,-2506,2506,-0.340720598,0.340720598
Minnesota,MN,Fillmore County,27,45,27045,Vikings,#4f2683,20834,3872,6271,10976,0.352769679,0.571337464,-2399,2399,-0.218567784,0.218567784
Minnesota,MN,Freeborn County,27,47,27047,Vikings,#4f2683,30613,6041,8808,15929,0.379245401,0.552953732,-2767,2767,-0.173708331,0.173708331
Minnesota,MN,Goodhue County,27,49,27049,Vikings,#4f2683,46435,9446,14041,25538,0.369880179,0.549808129,-4595,4595,-0.179927951,0.179927951
Minnesota,MN,Grant County,27,51,27051,Vikings,#4f2683,5903,1104,2063,3453,0.319721981,0.597451491,-959,959,-0.277729511,0.277729511
Minnesota,MN,Hennepin County,27,53,27053,Vikings,#4f2683,1223149,429283,191768,672644,0.638202377,0.285095831,237515,-237515,0.353106547,-0.353106547
Minnesota,MN,Houston County,27,55,27055,Vikings,#4f2683,18773,4145,5616,10515,0.394198764,0.534094151,-1471,1471,-0.139895388,0.139895388
Minnesota,MN,Hubbard County,27,57,27057,Vikings,#4f2683,20655,3432,7269,11423,0.300446468,0.63634772,-3837,3837,-0.335901252,0.335901252
Minnesota,MN,Isanti County,27,59,27059,Vikings,#4f2683,38429,5656,13635,20875,0.270946108,0.653173653,-7979,7979,-0.382227545,0.382227545
Minnesota,MN,Itasca County,27,61,27061,Vikings,#4f2683,45435,9015,12920,23650,0.381183932,0.546300211,-3905,3905,-0.165116279,0.165116279
Minnesota,MN,Jackson County,27,63,27063,Vikings,#4f2683,10079,1492,3609,5453,0.273610856,0.661837521,-2117,2117,-0.388226664,0.388226664
Minnesota,MN,Kanabec County,27,65,27065,Vikings,#4f2683,15837,2327,5230,8125,0.2864,0.643692308,-2903,2903,-0.357292308,0.357292308
Minnesota,MN,Kandiyohi County,27,67,27067,Vikings,#4f2683,42542,7266,12785,21648,0.335643016,0.590585735,-5519,5519,-0.25494272,0.25494272
Minnesota,MN,Kittson County,27,69,27069,Vikings,#4f2683,4424,823,1349,2363,0.348286077,0.570884469,-526,526,-0.222598392,0.222598392
Minnesota,MN,Koochiching County,27,71,27071,Vikings,#4f2683,12841,2306,3569,6313,0.365277998,0.565341359,-1263,1263,-0.200063361,0.200063361
Minnesota,MN,Lac qui Parle County,27,73,27073,Vikings,#4f2683,6856,1301,2294,3835,0.339243807,0.598174707,-993,993,-0.2589309,0.2589309
Minnesota,MN,Lake County,27,75,27075,Vikings,#4f2683,10631,3077,2932,6472,0.475432633,0.45302843,145,-145,0.022404203,-0.022404203
Minnesota,MN,Lake of the Woods County,27,77,27077,Vikings,#4f2683,3923,553,1540,2230,0.247982063,0.69058296,-987,987,-0.442600897,0.442600897
Minnesota,MN,Le Sueur County,27,79,27079,Vikings,#4f2683,27663,4623,9182,14867,0.310957153,0.617609471,-4559,4559,-0.306652317,0.306652317
Minnesota,MN,Lincoln County,27,81,27081,Vikings,#4f2683,5771,860,1930,3002,0.286475683,0.64290473,-1070,1070,-0.356429047,0.356429047
Minnesota,MN,Lyon County,27,83,27083,Vikings,#4f2683,25673,3825,7256,12129,0.315359881,0.598235634,-3431,3431,-0.282875752,0.282875752
Minnesota,MN,McLeod County,27,85,27085,Vikings,#4f2683,35932,4978,12155,18684,0.266431171,0.650556626,-7177,7177,-0.384125455,0.384125455
Minnesota,MN,Mahnomen County,27,87,27087,Vikings,#4f2683,5457,930,991,2074,0.448408872,0.477820636,-61,61,-0.029411765,0.029411765
Minnesota,MN,Marshall County,27,89,27089,Vikings,#4f2683,9423,1225,3208,4794,0.255527743,0.669169796,-1983,1983,-0.413642053,0.413642053
Minnesota,MN,Martin County,27,91,27091,Vikings,#4f2683,20022,2733,7062,10469,0.261056452,0.674562996,-4329,4329,-0.413506543,0.413506543
Minnesota,MN,Meeker County,27,93,27093,Vikings,#4f2683,23102,3192,8103,12198,0.261682243,0.664289228,-4911,4911,-0.402606985,0.402606985
Minnesota,MN,Mille Lacs County,27,95,27095,Vikings,#4f2683,25788,3709,8340,12948,0.286453506,0.644114921,-4631,4631,-0.357661415,0.357661415
Minnesota,MN,Morrison County,27,97,27097,Vikings,#4f2683,32775,3637,12925,17534,0.207425573,0.737139272,-9288,9288,-0.529713699,0.529713699
Minnesota,MN,Mower County,27,99,27099,Vikings,#4f2683,39116,7444,8826,17587,0.423267186,0.501847956,-1382,1382,-0.07858077,0.07858077
Minnesota,MN,Murray County,27,101,27101,Vikings,#4f2683,8413,1295,2974,4642,0.27897458,0.640672124,-1679,1679,-0.361697544,0.361697544
Minnesota,MN,Nicollet County,27,103,27103,Vikings,#4f2683,33347,7886,8436,17914,0.440214357,0.470916602,-550,550,-0.030702244,0.030702244
Minnesota,MN,Nobles County,27,105,27105,Vikings,#4f2683,21770,2733,5299,8592,0.318086592,0.616736499,-2566,2566,-0.298649907,0.298649907
Minnesota,MN,Norman County,27,107,27107,Vikings,#4f2683,6678,1264,1699,3232,0.391089109,0.525680693,-435,435,-0.134591584,0.134591584
Minnesota,MN,Olmsted County,27,109,27109,Vikings,#4f2683,151436,36266,35668,79277,0.457459288,0.449916117,598,-598,0.007543171,-0.007543171
Minnesota,MN,Otter Tail County,27,111,27111,Vikings,#4f2683,57716,9339,20939,32284,0.289276422,0.648587536,-11600,11600,-0.359311114,0.359311114
Minnesota,MN,Pennington County,27,113,27113,Vikings,#4f2683,14219,2146,4000,6671,0.321690901,0.599610253,-1854,1854,-0.277919352,0.277919352
Minnesota,MN,Pine County,27,115,27115,Vikings,#4f2683,29069,4580,8191,13729,0.333600408,0.596620293,-3611,3611,-0.263019885,0.263019885
Minnesota,MN,Pipestone County,27,117,27117,Vikings,#4f2683,9271,1127,3338,4779,0.235823394,0.698472484,-2211,2211,-0.46264909,0.46264909
Minnesota,MN,Polk County,27,119,27119,Vikings,#4f2683,31533,4712,8979,14698,0.320587835,0.610899442,-4267,4267,-0.290311607,0.290311607
Minnesota,MN,Pope County,27,121,27121,Vikings,#4f2683,11041,2106,3793,6294,0.334604385,0.602637432,-1687,1687,-0.268033047,0.268033047
Minnesota,MN,Ramsey County,27,123,27123,Vikings,#4f2683,538133,176929,70778,269161,0.657335201,0.262957858,106151,-106151,0.394377343,-0.394377343
Minnesota,MN,Red Lake County,27,125,27125,Vikings,#4f2683,4055,540,1141,1871,0.288615714,0.609834313,-601,601,-0.3212186,0.3212186
Minnesota,MN,Redwood County,27,127,27127,Vikings,#4f2683,15471,1887,5137,7566,0.249405234,0.678958499,-3250,3250,-0.429553265,0.429553265
Minnesota,MN,Renville County,27,129,27129,Vikings,#4f2683,14892,2117,4890,7563,0.279915377,0.646568822,-2773,2773,-0.366653444,0.366653444
Minnesota,MN,Rice County,27,131,27131,Vikings,#4f2683,65400,14437,15429,32217,0.448117454,0.478908651,-992,992,-0.030791197,0.030791197
Minnesota,MN,Rock County,27,133,27133,Vikings,#4f2683,9600,1373,3091,4807,0.28562513,0.643020595,-1718,1718,-0.357395465,0.357395465
Minnesota,MN,Roseau County,27,135,27135,Vikings,#4f2683,15770,1856,5451,7767,0.238959701,0.701815373,-3595,3595,-0.462855671,0.462855671
Minnesota,MN,St. Louis County,27,137,27137,Vikings,#4f2683,200431,57769,44631,111260,0.519225238,0.40114147,13138,-13138,0.118083768,-0.118083768
Minnesota,MN,Scott County,27,139,27139,Vikings,#4f2683,141660,28502,39948,74390,0.383142896,0.537007662,-11446,11446,-0.153864767,0.153864767
Minnesota,MN,Sherburne County,27,141,27141,Vikings,#4f2683,91705,13299,31049,47938,0.277420835,0.647690767,-17750,17750,-0.370269932,0.370269932
Minnesota,MN,Sibley County,27,143,27143,Vikings,#4f2683,14875,1954,5193,7727,0.252879513,0.672059014,-3239,3239,-0.4191795,0.4191795
Minnesota,MN,Stearns County,27,145,27145,Vikings,#4f2683,154708,25575,47618,78985,0.323795657,0.602873963,-22043,22043,-0.279078306,0.279078306
Minnesota,MN,Steele County,27,147,27147,Vikings,#4f2683,36755,6239,11198,19040,0.327678571,0.588130252,-4959,4959,-0.260451681,0.260451681
Minnesota,MN,Stevens County,27,149,27149,Vikings,#4f2683,9796,2116,2800,5350,0.395514019,0.523364486,-684,684,-0.127850467,0.127850467
Minnesota,MN,Swift County,27,151,27151,Vikings,#4f2683,9340,1679,2962,4968,0.337962963,0.596215781,-1283,1283,-0.258252818,0.258252818
Minnesota,MN,Todd County,27,153,27153,Vikings,#4f2683,24257,2783,8485,11944,0.233004019,0.710398526,-5702,5702,-0.477394508,0.477394508
Minnesota,MN,Traverse County,27,155,27155,Vikings,#4f2683,3401,631,1050,1791,0.352317141,0.586264657,-419,419,-0.233947515,0.233947515
Minnesota,MN,Wabasha County,27,157,27157,Vikings,#4f2683,21239,3866,6989,11764,0.328629718,0.594100646,-3123,3123,-0.265470928,0.265470928
Minnesota,MN,Wadena County,27,159,27159,Vikings,#4f2683,13875,1684,4837,6894,0.24427038,0.701624601,-3153,3153,-0.457354221,0.457354221
Minnesota,MN,Waseca County,27,161,27161,Vikings,#4f2683,18989,2838,5967,9579,0.296273097,0.622925149,-3129,3129,-0.326652051,0.326652051
Minnesota,MN,Washington County,27,163,27163,Vikings,#4f2683,251597,67086,64429,142843,0.469648495,0.451047654,2657,-2657,0.018600841,-0.018600841
Minnesota,MN,Watonwan County,27,165,27165,Vikings,#4f2683,10952,1814,2768,4971,0.364916516,0.556829612,-954,954,-0.191913096,0.191913096
Minnesota,MN,Wilkin County,27,167,27167,Vikings,#4f2683,6396,893,2129,3279,0.272339128,0.649283318,-1236,1236,-0.37694419,0.37694419
Minnesota,MN,Winona County,27,169,27169,Vikings,#4f2683,50885,11366,12122,25852,0.439656506,0.468899892,-756,756,-0.029243385,0.029243385
Minnesota,MN,Wright County,27,171,27171,Vikings,#4f2683,131311,20336,43274,69154,0.294068311,0.62576279,-22938,22938,-0.331694479,0.331694479
Minnesota,MN,Yellow Medicine County,27,173,27173,Vikings,#4f2683,9875,1524,3382,5253,0.290119931,0.643822578,-1858,1858,-0.353702646,0.353702646
Mississippi,MS,Adams County,28,1,28001,Saints,#9f8958,31254,6921,5125,12214,0.566644834,0.419600458,1796,-1796,0.147044375,-0.147044375
Mississippi,MS,Alcorn County,28,3,28003,Saints,#9f8958,37388,2684,11817,14781,0.181584467,0.799472296,-9133,9133,-0.617887829,0.617887829
Mississippi,MS,Amite County,28,5,28005,Saints,#9f8958,12574,2688,4282,7033,0.382198208,0.608844021,-1594,1594,-0.226645813,0.226645813
Mississippi,MS,Attala County,28,7,28007,Saints,#9f8958,19043,2847,4288,7242,0.393123447,0.592101629,-1441,1441,-0.198978183,0.198978183
Mississippi,MS,Benton County,28,9,28009,Saints,#9f8958,8182,1713,2240,3996,0.428678679,0.560560561,-527,527,-0.131881882,0.131881882
Mississippi,MS,Bolivar County,28,11,28011,Saints,#9f8958,33322,8410,4251,12831,0.655443847,0.331306991,4159,-4159,0.324136856,-0.324136856
Mississippi,MS,Calhoun County,28,13,28013,Saints,#9f8958,14717,1884,4360,6339,0.297207761,0.687805648,-2476,2476,-0.390597886,0.390597886
Mississippi,MS,Carroll County,28,15,28015,Saints,#9f8958,10243,1648,3774,5470,0.301279707,0.689945155,-2126,2126,-0.388665448,0.388665448
Mississippi,MS,Chickasaw County,28,17,28017,Saints,#9f8958,17328,3649,4127,7890,0.462484157,0.523067174,-478,478,-0.060583016,0.060583016
Mississippi,MS,Choctaw County,28,19,28019,Saints,#9f8958,8299,1198,2763,4020,0.29800995,0.687313433,-1565,1565,-0.389303483,0.389303483
Mississippi,MS,Claiborne County,28,21,28021,Saints,#9f8958,9150,2523,414,2954,0.854096141,0.140148951,2109,-2109,0.71394719,-0.71394719
Mississippi,MS,Clarke County,28,23,28023,Saints,#9f8958,16006,2556,5088,7713,0.331388565,0.6596655,-2532,2532,-0.328276935,0.328276935
Mississippi,MS,Clay County,28,25,28025,Saints,#9f8958,20048,5695,4136,9960,0.571787149,0.415261044,1559,-1559,0.156526104,-0.156526104
Mississippi,MS,Coahoma County,28,27,28027,Saints,#9f8958,24620,6378,2426,8912,0.715664273,0.272217235,3952,-3952,0.443447038,-0.443447038
Mississippi,MS,Copiah County,28,29,28029,Saints,#9f8958,28773,6203,5576,11906,0.520997816,0.468335293,627,-627,0.052662523,-0.052662523
Mississippi,MS,Covington County,28,31,28031,Saints,#9f8958,19543,3267,5423,8790,0.371672355,0.616951081,-2156,2156,-0.245278726,0.245278726
Mississippi,MS,DeSoto County,28,33,28033,Cowboys,#002244,173323,19892,42155,64022,0.310705695,0.658445534,-22263,22263,-0.347739839,0.347739839
Mississippi,MS,Forrest County,28,35,28035,Saints,#9f8958,75944,11271,15149,27284,0.413099252,0.555233837,-3878,3878,-0.142134584,0.142134584
Mississippi,MS,Franklin County,28,37,28037,Saints,#9f8958,7743,1471,2685,4219,0.34866082,0.636406731,-1214,1214,-0.287745911,0.287745911
Mississippi,MS,George County,28,39,28039,Saints,#9f8958,23373,1013,8652,9831,0.1030414,0.880073238,-7639,7639,-0.777031838,0.777031838
Mississippi,MS,Greene County,28,41,28041,Saints,#9f8958,13522,956,4309,5325,0.179530516,0.809201878,-3353,3353,-0.629671362,0.629671362
Mississippi,MS,Grenada County,28,43,28043,Saints,#9f8958,21578,4386,5940,10442,0.420034476,0.568856541,-1554,1554,-0.148822065,0.148822065
Mississippi,MS,Hancock County,28,45,28045,Saints,#9f8958,46420,3320,13720,17517,0.189530171,0.783239139,-10400,10400,-0.593708968,0.593708968
Mississippi,MS,Harrison County,28,47,28047,Saints,#9f8958,201410,20679,39710,62076,0.333123913,0.639699723,-19031,19031,-0.30657581,0.30657581
Mississippi,MS,Hinds County,28,49,28049,Saints,#9f8958,242891,64922,24919,91536,0.709251005,0.27223169,40003,-40003,0.437019315,-0.437019315
Mississippi,MS,Holmes County,28,51,28051,Saints,#9f8958,18340,5820,1151,7045,0.826117814,0.163378282,4669,-4669,0.662739532,-0.662739532
Mississippi,MS,Humphreys County,28,53,28053,Saints,#9f8958,8669,2652,924,3599,0.736871353,0.256737983,1728,-1728,0.48013337,-0.48013337
Mississippi,MS,Issaquena County,28,55,28055,Saints,#9f8958,1337,395,298,699,0.56509299,0.426323319,97,-97,0.138769671,-0.138769671
Mississippi,MS,Itawamba County,28,57,28057,Saints,#9f8958,23609,1100,8385,9634,0.11417895,0.870354993,-7285,7285,-0.756176043,0.756176043
Mississippi,MS,Jackson County,28,59,28059,Saints,#9f8958,141425,13087,31204,45465,0.287847795,0.686330144,-18117,18117,-0.398482349,0.398482349
Mississippi,MS,Jasper County,28,61,28061,Saints,#9f8958,16569,4367,4032,8468,0.515706188,0.476145489,335,-335,0.039560699,-0.039560699
Mississippi,MS,Jefferson County,28,63,28063,Saints,#9f8958,7507,3337,489,3859,0.864731796,0.126716766,2848,-2848,0.73801503,-0.73801503
Mississippi,MS,Jefferson Davis County,28,65,28065,Saints,#9f8958,11665,3720,2466,6237,0.596440596,0.395382395,1254,-1254,0.201058201,-0.201058201
Mississippi,MS,Jones County,28,67,28067,Saints,#9f8958,68215,7748,20076,28250,0.274265487,0.710654867,-12328,12328,-0.436389381,0.436389381
Mississippi,MS,Kemper County,28,69,28069,Saints,#9f8958,9969,2827,1778,4639,0.609398577,0.383272257,1049,-1049,0.22612632,-0.22612632
Mississippi,MS,Lafayette County,28,71,28071,Saints,#9f8958,53154,7968,10872,19642,0.405661338,0.553507789,-2904,2904,-0.147846451,0.147846451
Mississippi,MS,Lamar County,28,73,28073,Saints,#9f8958,60618,5044,18493,24179,0.208610778,0.764837255,-13449,13449,-0.556226478,0.556226478
Mississippi,MS,Lauderdale County,28,75,28075,Saints,#9f8958,78524,10910,17574,28967,0.376635482,0.606690372,-6664,6664,-0.23005489,0.23005489
Mississippi,MS,Lawrence County,28,77,28077,Saints,#9f8958,12622,2181,4072,6329,0.344604203,0.643387581,-1891,1891,-0.298783378,0.298783378
Mississippi,MS,Leake County,28,79,28079,Saints,#9f8958,22763,3579,4775,8436,0.424253201,0.566026553,-1196,1196,-0.141773352,0.141773352
Mississippi,MS,Lee County,28,81,28081,Saints,#9f8958,85300,9635,21695,31974,0.301338588,0.678520048,-12060,12060,-0.37718146,0.37718146
Mississippi,MS,Leflore County,28,83,28083,Saints,#9f8958,30999,6677,2757,9566,0.697992891,0.288208238,3920,-3920,0.409784654,-0.409784654
Mississippi,MS,Lincoln County,28,85,28085,Saints,#9f8958,34649,4458,10550,15193,0.293424603,0.694398736,-6092,6092,-0.400974133,0.400974133
Mississippi,MS,Lowndes County,28,87,28087,Saints,#9f8958,59710,11545,13124,25139,0.459246589,0.522057361,-1579,1579,-0.062810772,0.062810772
Mississippi,MS,Madison County,28,89,28089,Saints,#9f8958,103465,18358,25607,45048,0.407520867,0.56843811,-7249,7249,-0.160917244,0.160917244
Mississippi,MS,Marion County,28,91,28091,Saints,#9f8958,25563,3572,7697,11443,0.312155903,0.672638294,-4125,4125,-0.360482391,0.360482391
Mississippi,MS,Marshall County,28,93,28093,Cowboys,#002244,35916,7944,6525,14698,0.540481698,0.443937951,1419,-1419,0.096543747,-0.096543747
Mississippi,MS,Monroe County,28,95,28095,Saints,#9f8958,35827,5485,10107,15781,0.347569862,0.64045371,-4622,4622,-0.292883848,0.292883848
Mississippi,MS,Montgomery County,28,97,28097,Saints,#9f8958,10152,1775,2334,4162,0.426477655,0.560788083,-559,559,-0.134310428,0.134310428
Mississippi,MS,Neshoba County,28,99,28099,Saints,#9f8958,29463,2668,7613,10438,0.255604522,0.729354282,-4945,4945,-0.47374976,0.47374976
Mississippi,MS,Newton County,28,101,28101,Saints,#9f8958,21747,2549,5929,8594,0.296602281,0.68989993,-3380,3380,-0.39329765,0.39329765
Mississippi,MS,Noxubee County,28,103,28103,Saints,#9f8958,11043,4330,1181,5538,0.781870711,0.213253882,3149,-3149,0.568616829,-0.568616829
Mississippi,MS,Oktibbeha County,28,105,28105,Saints,#9f8958,49800,7851,7671,16151,0.486099932,0.474955111,180,-180,0.011144821,-0.011144821
Mississippi,MS,Panola County,28,107,28107,Saints,#9f8958,34167,7300,7371,14854,0.491450114,0.496229972,-71,71,-0.004779857,0.004779857
Mississippi,MS,Pearl River County,28,109,28109,Saints,#9f8958,55191,2919,15530,18893,0.154501667,0.821997565,-12611,12611,-0.667495898,0.667495898
Mississippi,MS,Perry County,28,111,28111,Saints,#9f8958,12277,1220,4135,5432,0.224594993,0.76122975,-2915,2915,-0.536634757,0.536634757
Mississippi,MS,Pike County,28,113,28113,Saints,#9f8958,39956,7636,7748,15633,0.488453912,0.495618243,-112,112,-0.007164332,0.007164332
Mississippi,MS,Pontotoc County,28,115,28115,Saints,#9f8958,30908,2123,9442,11811,0.179747693,0.799424266,-7319,7319,-0.619676573,0.619676573
Mississippi,MS,Prentiss County,28,117,28117,Saints,#9f8958,25459,2067,7647,9871,0.209401276,0.774693547,-5580,5580,-0.56529227,0.56529227
Mississippi,MS,Quitman County,28,119,28119,Saints,#9f8958,7486,2303,998,3353,0.686847599,0.297643901,1305,-1305,0.389203698,-0.389203698
Mississippi,MS,Rankin County,28,121,28121,Saints,#9f8958,149039,13741,46168,61356,0.223955277,0.752461047,-32427,32427,-0.52850577,0.52850577
Mississippi,MS,Scott County,28,123,28123,Saints,#9f8958,28265,3999,5742,9867,0.405290362,0.581939799,-1743,1743,-0.176649438,0.176649438
Mississippi,MS,Sharkey County,28,125,28125,Saints,#9f8958,4585,1290,619,1926,0.669781931,0.321391485,671,-671,0.348390447,-0.348390447
Mississippi,MS,Simpson County,28,127,28127,Saints,#9f8958,27222,3871,7393,11416,0.339085494,0.64759986,-3522,3522,-0.308514366,0.308514366
Mississippi,MS,Smith County,28,129,28129,Saints,#9f8958,16059,1598,5877,7556,0.21148756,0.777792483,-4279,4279,-0.566304923,0.566304923
Mississippi,MS,Stone County,28,131,28131,Saints,#9f8958,18070,1400,4810,6368,0.219849246,0.755339196,-3410,3410,-0.53548995,0.53548995
Mississippi,MS,Sunflower County,28,133,28133,Saints,#9f8958,27005,6560,2768,9406,0.697427174,0.294280247,3792,-3792,0.403146927,-0.403146927
Mississippi,MS,Tallahatchie County,28,135,28135,Saints,#9f8958,14588,3337,2462,5870,0.568483816,0.419420784,875,-875,0.149063032,-0.149063032
Mississippi,MS,Tate County,28,137,28137,Cowboys,#002244,28296,3804,7385,11389,0.334006497,0.648432698,-3581,3581,-0.314426201,0.314426201
Mississippi,MS,Tippah County,28,139,28139,Saints,#9f8958,22131,1808,7182,9143,0.19774691,0.785518976,-5374,5374,-0.587772066,0.587772066
Mississippi,MS,Tishomingo County,28,141,28141,Saints,#9f8958,19552,990,7117,8310,0.119133574,0.856438026,-6127,6127,-0.737304452,0.737304452
Mississippi,MS,Tunica County,28,143,28143,Cowboys,#002244,10343,2577,840,3463,0.744152469,0.242564251,1737,-1737,0.501588218,-0.501588218
Mississippi,MS,Union County,28,145,28145,Saints,#9f8958,28429,1969,9161,11374,0.17311412,0.805433445,-7192,7192,-0.632319325,0.632319325
Mississippi,MS,Walthall County,28,147,28147,Saints,#9f8958,14638,2475,3374,5909,0.418852598,0.5709934,-899,899,-0.152140802,0.152140802
Mississippi,MS,Warren County,28,149,28149,Saints,#9f8958,47485,8518,9420,18287,0.465795374,0.515120031,-902,902,-0.049324657,0.049324657
Mississippi,MS,Washington County,28,151,28151,Saints,#9f8958,48130,9847,4541,14571,0.675794386,0.311646421,5306,-5306,0.364147965,-0.364147965
Mississippi,MS,Wayne County,28,153,28153,Saints,#9f8958,20566,3493,5957,9534,0.366372981,0.624816446,-2464,2464,-0.258443465,0.258443465
Mississippi,MS,Webster County,28,155,28155,Saints,#9f8958,9899,1001,3949,5024,0.199243631,0.78602707,-2948,2948,-0.586783439,0.586783439
Mississippi,MS,Wilkinson County,28,157,28157,Saints,#9f8958,9122,2826,1305,4174,0.677048395,0.312649736,1521,-1521,0.364398658,-0.364398658
Mississippi,MS,Winston County,28,159,28159,Saints,#9f8958,18317,3778,4874,8771,0.430737658,0.555694904,-1096,1096,-0.124957245,0.124957245
Mississippi,MS,Yalobusha County,28,161,28161,Saints,#9f8958,12447,2574,3366,6058,0.424892704,0.55562892,-792,792,-0.130736217,0.130736217
Mississippi,MS,Yazoo County,28,163,28163,Saints,#9f8958,27387,5221,4568,9892,0.527800243,0.461787303,653,-653,0.06601294,-0.06601294
Missouri,MO,Adair County,29,1,29001,Chiefs,#e31837,25378,3495,6019,10137,0.344776561,0.593765414,-2524,2524,-0.248988853,0.248988853
Missouri,MO,Andrew County,29,3,29003,Chiefs,#e31837,17296,2045,6665,9140,0.223741794,0.729212254,-4620,4620,-0.50547046,0.50547046
Missouri,MO,Atchison County,29,5,29005,Chiefs,#e31837,5306,541,2059,2723,0.198677929,0.756151304,-1518,1518,-0.557473375,0.557473375
Missouri,MO,Audrain County,29,7,29007,Chiefs,#e31837,26096,2567,6981,10043,0.255600916,0.695111023,-4414,4414,-0.439510107,0.439510107
Missouri,MO,Barry County,29,9,29009,Chiefs,#e31837,35829,2710,11427,14604,0.185565598,0.782456861,-8717,8717,-0.596891263,0.596891263
Missouri,MO,Barton County,29,11,29011,Chiefs,#e31837,11880,795,4958,5932,0.134018881,0.835805799,-4163,4163,-0.701786918,0.701786918
Missouri,MO,Bates County,29,13,29013,Chiefs,#e31837,16446,1617,6000,8021,0.201595811,0.748036404,-4383,4383,-0.546440593,0.546440593
Missouri,MO,Benton County,29,15,29015,Chiefs,#e31837,18670,2024,7212,9584,0.211185309,0.752504174,-5188,5188,-0.541318865,0.541318865
Missouri,MO,Bollinger County,29,17,29017,Rams,#b3995d,12182,705,4827,5669,0.124360557,0.851472923,-4122,4122,-0.727112365,0.727112365
Missouri,MO,Boone County,29,19,29019,Chiefs,#e31837,174974,41072,36146,83312,0.492990205,0.433863069,4926,-4926,0.059127137,-0.059127137
Missouri,MO,Buchanan County,29,21,29021,Chiefs,#e31837,89100,12010,21315,35563,0.337710542,0.599358884,-9305,9305,-0.261648342,0.261648342
Missouri,MO,Butler County,29,23,29023,Rams,#b3995d,42951,3036,13647,17232,0.176183844,0.791956825,-10611,10611,-0.615772981,0.615772981
Missouri,MO,Caldwell County,29,25,29025,Chiefs,#e31837,9014,837,3231,4309,0.194244604,0.749825946,-2394,2394,-0.555581341,0.555581341
Missouri,MO,Callaway County,29,27,29027,Chiefs,#e31837,44834,4988,13052,19127,0.260783186,0.682386156,-8064,8064,-0.42160297,0.42160297
Missouri,MO,Camden County,29,29,29029,Chiefs,#e31837,44237,4706,16721,22182,0.212153999,0.753809395,-12015,12015,-0.541655396,0.541655396
Missouri,MO,Cape Girardeau County,29,31,29031,Rams,#b3995d,78572,8468,26939,36875,0.229640678,0.730549153,-18471,18471,-0.500908475,0.500908475
Missouri,MO,Carroll County,29,33,29033,Chiefs,#e31837,8992,745,3480,4361,0.170832378,0.797982114,-2735,2735,-0.627149736,0.627149736
Missouri,MO,Carter County,29,35,29035,Rams,#b3995d,6263,436,2323,2842,0.153413089,0.817382125,-1887,1887,-0.663969036,0.663969036
Missouri,MO,Cass County,29,37,29037,Chiefs,#e31837,101603,14816,33006,50715,0.292142364,0.650813369,-18190,18190,-0.358671005,0.358671005
Missouri,MO,Cedar County,29,39,29039,Chiefs,#e31837,13934,1010,5019,6278,0.160879261,0.799458426,-4009,4009,-0.638579165,0.638579165
Missouri,MO,Chariton County,29,41,29041,Chiefs,#e31837,7589,888,2948,3962,0.224129228,0.744068652,-2060,2060,-0.519939425,0.519939425
Missouri,MO,Christian County,29,43,29043,Chiefs,#e31837,83279,8505,30941,41394,0.20546456,0.74747548,-22436,22436,-0.542010919,0.542010919
Missouri,MO,Clark County,29,45,29045,Chiefs,#e31837,6801,724,2458,3316,0.218335344,0.741254524,-1734,1734,-0.52291918,0.52291918
Missouri,MO,Clay County,29,47,29047,Chiefs,#e31837,235637,45182,57328,109237,0.413614435,0.524803867,-12146,12146,-0.111189432,0.111189432
Missouri,MO,Clinton County,29,49,29049,Chiefs,#e31837,20609,2572,7058,10197,0.252231048,0.692164362,-4486,4486,-0.439933314,0.439933314
Missouri,MO,Cole County,29,51,29051,Chiefs,#e31837,76720,10907,24610,37261,0.292718929,0.660476101,-13703,13703,-0.367757172,0.367757172
Missouri,MO,Cooper County,29,53,29053,Chiefs,#e31837,17642,1932,5623,7976,0.24222668,0.70498997,-3691,3691,-0.46276329,0.46276329
Missouri,MO,Crawford County,29,55,29055,Rams,#b3995d,24526,1824,7724,9920,0.183870968,0.778629032,-5900,5900,-0.594758065,0.594758065
Missouri,MO,Dade County,29,57,29057,Chiefs,#e31837,7595,637,3184,3951,0.161225006,0.805871931,-2547,2547,-0.644646925,0.644646925
Missouri,MO,Dallas County,29,59,29059,Chiefs,#e31837,16393,1271,5895,7440,0.170833333,0.79233871,-4624,4624,-0.621505376,0.621505376
Missouri,MO,Daviess County,29,61,29061,Chiefs,#e31837,8253,730,2763,3689,0.197885606,0.748983464,-2033,2033,-0.551097858,0.551097858
Missouri,MO,DeKalb County,29,63,29063,Chiefs,#e31837,12687,824,3540,4590,0.179520697,0.77124183,-2716,2716,-0.591721133,0.591721133
Missouri,MO,Dent County,29,65,29065,Rams,#b3995d,15593,978,5599,6778,0.144290351,0.826054883,-4621,4621,-0.681764532,0.681764532
Missouri,MO,Douglas County,29,67,29067,Chiefs,#e31837,13373,984,5486,6664,0.147659064,0.823229292,-4502,4502,-0.675570228,0.675570228
Missouri,MO,Dunklin County,29,69,29069,Rams,#b3995d,30895,2360,8026,10574,0.223188954,0.759031587,-5666,5666,-0.535842633,0.535842633
Missouri,MO,Franklin County,29,71,29071,Rams,#b3995d,102426,12339,35420,50045,0.246558098,0.707763013,-23081,23081,-0.461204916,0.461204916
Missouri,MO,Gasconade County,29,73,29073,Rams,#b3995d,14858,1519,5670,7444,0.204056959,0.761687265,-4151,4151,-0.557630306,0.557630306
Missouri,MO,Gentry County,29,75,29075,Chiefs,#e31837,6692,605,2304,3033,0.19947247,0.759643917,-1699,1699,-0.560171447,0.560171447
Missouri,MO,Greene County,29,77,29077,Chiefs,#e31837,288072,42400,77387,127609,0.332264966,0.606438417,-34987,34987,-0.274173452,0.274173452
Missouri,MO,Grundy County,29,79,29079,Chiefs,#e31837,10097,780,3462,4413,0.17675051,0.78450034,-2682,2682,-0.60774983,0.60774983
Missouri,MO,Harrison County,29,81,29081,Chiefs,#e31837,8615,574,2965,3682,0.155893536,0.805268876,-2391,2391,-0.649375339,0.649375339
Missouri,MO,Henry County,29,83,29083,Chiefs,#e31837,21737,2356,7072,9855,0.239066464,0.717605277,-4716,4716,-0.478538813,0.478538813
Missouri,MO,Hickory County,29,85,29085,Chiefs,#e31837,9201,1016,3539,4717,0.215391138,0.750264999,-2523,2523,-0.534873861,0.534873861
Missouri,MO,Holt County,29,87,29087,Chiefs,#e31837,4484,346,1926,2348,0.147359455,0.820272572,-1580,1580,-0.672913118,0.672913118
Missouri,MO,Howard County,29,89,29089,Chiefs,#e31837,10139,1279,3277,4851,0.263656978,0.675530818,-1998,1998,-0.41187384,0.41187384
Missouri,MO,Howell County,29,91,29091,Chiefs,#e31837,40117,2880,13888,17415,0.165374677,0.797473442,-11008,11008,-0.632098765,0.632098765
Missouri,MO,Iron County,29,93,29093,Rams,#b3995d,10125,933,3173,4260,0.219014085,0.744835681,-2240,2240,-0.525821596,0.525821596
Missouri,MO,Jackson County,29,95,29095,Chiefs,#e31837,687623,163723,114777,294063,0.556761646,0.39031432,48946,-48946,0.166447326,-0.166447326
Missouri,MO,Jasper County,29,97,29097,Chiefs,#e31837,118596,10565,35058,48179,0.219286411,0.727661429,-24493,24493,-0.508375018,0.508375018
Missouri,MO,Jefferson County,29,99,29099,Rams,#b3995d,224124,31546,68973,105969,0.297690834,0.650879031,-37427,37427,-0.353188197,0.353188197
Missouri,MO,Johnson County,29,101,29101,Chiefs,#e31837,53951,5924,13702,21087,0.28093138,0.649784227,-7778,7778,-0.368852848,0.368852848
Missouri,MO,Knox County,29,103,29103,Chiefs,#e31837,3910,379,1413,1867,0.202999464,0.756829138,-1034,1034,-0.553829673,0.553829673
Missouri,MO,Laclede County,29,105,29105,Chiefs,#e31837,35473,2543,12834,15959,0.159345824,0.804185726,-10291,10291,-0.644839902,0.644839902
Missouri,MO,Lafayette County,29,107,29107,Chiefs,#e31837,32701,4047,10977,15815,0.255896301,0.694087891,-6930,6930,-0.43819159,0.43819159
Missouri,MO,Lawrence County,29,109,29109,Chiefs,#e31837,38180,2898,13084,16674,0.173803526,0.784694734,-10186,10186,-0.610891208,0.610891208
Missouri,MO,Lewis County,29,111,29111,Chiefs,#e31837,10207,933,3343,4452,0.209568733,0.750898473,-2410,2410,-0.541329739,0.541329739
Missouri,MO,Lincoln County,29,113,29113,Rams,#b3995d,54696,5561,18111,24857,0.223719677,0.728607636,-12550,12550,-0.504887959,0.504887959
Missouri,MO,Linn County,29,115,29115,Chiefs,#e31837,12308,1239,4084,5572,0.222361809,0.732950467,-2845,2845,-0.510588658,0.510588658
Missouri,MO,Livingston County,29,117,29117,Chiefs,#e31837,15028,1265,4879,6408,0.197409488,0.76139201,-3614,3614,-0.563982522,0.563982522
Missouri,MO,McDonald County,29,119,29119,Chiefs,#e31837,22643,1329,6599,8233,0.161423539,0.801530426,-5270,5270,-0.640106887,0.640106887
Missouri,MO,Macon County,29,121,29121,Chiefs,#e31837,15335,1518,5794,7579,0.200290276,0.764480802,-4276,4276,-0.564190526,0.564190526
Missouri,MO,Madison County,29,123,29123,Rams,#b3995d,12408,1005,4102,5318,0.18898082,0.77134261,-3097,3097,-0.58236179,0.58236179
Missouri,MO,Maries County,29,125,29125,Chiefs,#e31837,8963,794,3559,4498,0.176522899,0.791240551,-2765,2765,-0.614717652,0.614717652
Missouri,MO,Marion County,29,127,29127,Chiefs,#e31837,28880,2993,9418,12902,0.231979538,0.729964347,-6425,6425,-0.497984809,0.497984809
Missouri,MO,Mercer County,29,129,29129,Chiefs,#e31837,3694,216,1486,1739,0.124209316,0.854514089,-1270,1270,-0.730304773,0.730304773
Missouri,MO,Miller County,29,131,29131,Chiefs,#e31837,25113,1750,9285,11414,0.153320484,0.81347468,-7535,7535,-0.660154197,0.660154197
Missouri,MO,Mississippi County,29,133,29133,Rams,#b3995d,14036,1458,3600,5165,0.282284608,0.696999032,-2142,2142,-0.414714424,0.414714424
Missouri,MO,Moniteau County,29,135,29135,Chiefs,#e31837,15963,1237,5344,6808,0.181698002,0.784958872,-4107,4107,-0.60326087,0.60326087
Missouri,MO,Monroe County,29,137,29137,Chiefs,#e31837,8583,853,3159,4147,0.205690861,0.761755486,-2306,2306,-0.556064625,0.556064625
Missouri,MO,Montgomery County,29,139,29139,Rams,#b3995d,11703,1118,4124,5424,0.206120944,0.760324484,-3006,3006,-0.55420354,0.55420354
Missouri,MO,Morgan County,29,141,29141,Chiefs,#e31837,20171,1768,6757,8815,0.200567215,0.766534317,-4989,4989,-0.565967102,0.565967102
Missouri,MO,New Madrid County,29,143,29143,Rams,#b3995d,18208,1933,5270,7352,0.262921654,0.716811752,-3337,3337,-0.453890098,0.453890098
Missouri,MO,Newton County,29,145,29145,Chiefs,#e31837,58615,4988,20546,26506,0.188183807,0.77514525,-15558,15558,-0.586961443,0.586961443
Missouri,MO,Nodaway County,29,147,29147,Chiefs,#e31837,22810,2529,6379,9439,0.267930925,0.675813116,-3850,3850,-0.407882191,0.407882191
Missouri,MO,Oregon County,29,149,29149,Chiefs,#e31837,10953,865,3668,4664,0.185463122,0.7864494,-2803,2803,-0.600986278,0.600986278
Missouri,MO,Osage County,29,151,29151,Chiefs,#e31837,13628,998,5845,7078,0.141000283,0.825798248,-4847,4847,-0.684797966,0.684797966
Missouri,MO,Ozark County,29,153,29153,Chiefs,#e31837,9409,724,3639,4501,0.160853144,0.808487003,-2915,2915,-0.647633859,0.647633859
Missouri,MO,Pemiscot County,29,155,29155,Cowboys,#002244,17482,1946,3964,6025,0.322987552,0.657925311,-2018,2018,-0.334937759,0.334937759
Missouri,MO,Perry County,29,157,29157,Rams,#b3995d,19183,1520,6907,8732,0.174072377,0.790998626,-5387,5387,-0.616926248,0.616926248
Missouri,MO,Pettis County,29,159,29159,Chiefs,#e31837,42255,4322,12792,18045,0.23951233,0.708894431,-8470,8470,-0.4693821,0.4693821
Missouri,MO,Phelps County,29,161,29161,Rams,#b3995d,44794,4761,12699,18499,0.257365263,0.686469539,-7938,7938,-0.429104276,0.429104276
Missouri,MO,Pike County,29,163,29163,Rams,#b3995d,18348,1806,5274,7375,0.244881356,0.715118644,-3468,3468,-0.470237288,0.470237288
Missouri,MO,Platte County,29,165,29165,Chiefs,#e31837,96096,18915,24975,46641,0.405544478,0.535473082,-6060,6060,-0.129928604,0.129928604
Missouri,MO,Polk County,29,167,29167,Chiefs,#e31837,31229,2630,10435,13709,0.191844774,0.761178788,-7805,7805,-0.569334014,0.569334014
Missouri,MO,Pulaski County,29,169,29169,Cowboys,#002244,53221,2918,9870,13443,0.217064643,0.734211114,-6952,6952,-0.51714647,0.51714647
Missouri,MO,Putnam County,29,171,29171,Chiefs,#e31837,4858,352,1936,2342,0.15029889,0.826643894,-1584,1584,-0.676345004,0.676345004
Missouri,MO,Ralls County,29,173,29173,Chiefs,#e31837,10196,1138,3969,5266,0.216103304,0.753703,-2831,2831,-0.537599696,0.537599696
Missouri,MO,Randolph County,29,175,29175,Chiefs,#e31837,25104,2283,7529,10309,0.221456979,0.730332719,-5246,5246,-0.50887574,0.50887574
Missouri,MO,Ray County,29,177,29177,Chiefs,#e31837,22810,3088,7103,10835,0.285002307,0.655560683,-4015,4015,-0.370558376,0.370558376
Missouri,MO,Reynolds County,29,179,29179,Rams,#b3995d,6432,540,2402,3032,0.178100264,0.792216359,-1862,1862,-0.614116095,0.614116095
Missouri,MO,Ripley County,29,181,29181,Rams,#b3995d,13802,830,4520,5518,0.150416818,0.819137369,-3690,3690,-0.668720551,0.668720551
Missouri,MO,St. Charles County,29,183,29183,Rams,#b3995d,385590,68225,120899,199513,0.341957667,0.605970538,-52674,52674,-0.264012871,0.264012871
Missouri,MO,St. Clair County,29,185,29185,Chiefs,#e31837,9440,936,3501,4630,0.202159827,0.756155508,-2565,2565,-0.55399568,0.55399568
Missouri,MO,Ste. Genevieve County,29,186,29186,Rams,#b3995d,17919,2540,5495,8459,0.3002719,0.649603972,-2955,2955,-0.349332072,0.349332072
Missouri,MO,St. Francois County,29,187,29187,Rams,#b3995d,66520,6250,17467,24714,0.252893097,0.706765396,-11217,11217,-0.453872299,0.453872299
Missouri,MO,St. Louis County,29,189,29189,Rams,#b3995d,1003362,280866,199081,503493,0.557834965,0.395399737,81785,-81785,0.162435228,-0.162435228
Missouri,MO,Saline County,29,195,29195,Chiefs,#e31837,23258,2787,5977,9245,0.301460249,0.646511628,-3190,3190,-0.345051379,0.345051379
Missouri,MO,Schuyler County,29,197,29197,Chiefs,#e31837,4436,354,1505,1933,0.183135023,0.778582514,-1151,1151,-0.595447491,0.595447491
Missouri,MO,Scotland County,29,199,29199,Chiefs,#e31837,4854,365,1525,1968,0.18546748,0.774898374,-1160,1160,-0.589430894,0.589430894
Missouri,MO,Scott County,29,201,29201,Rams,#b3995d,39008,3574,13168,17244,0.207260496,0.763627929,-9594,9594,-0.556367432,0.556367432
Missouri,MO,Shannon County,29,203,29203,Chiefs,#e31837,8258,776,2966,3904,0.198770492,0.759733607,-2190,2190,-0.560963115,0.560963115
Missouri,MO,Shelby County,29,205,29205,Chiefs,#e31837,6128,606,2524,3252,0.186346863,0.776137761,-1918,1918,-0.589790898,0.589790898
Missouri,MO,Stoddard County,29,207,29207,Rams,#b3995d,29862,1873,11077,13278,0.141060401,0.834237084,-9204,9204,-0.693176683,0.693176683
Missouri,MO,Stone County,29,209,29209,Chiefs,#e31837,30943,2886,13149,16538,0.174507196,0.795078002,-10263,10263,-0.620570807,0.620570807
Missouri,MO,Sullivan County,29,211,29211,Chiefs,#e31837,6353,526,1884,2484,0.211755233,0.758454106,-1358,1358,-0.546698873,0.546698873
Missouri,MO,Taney County,29,213,29213,Chiefs,#e31837,54592,4367,18240,23399,0.186631907,0.779520492,-13873,13873,-0.592888585,0.592888585
Missouri,MO,Texas County,29,215,29215,Chiefs,#e31837,25690,1728,8875,10935,0.158024691,0.811614083,-7147,7147,-0.653589392,0.653589392
Missouri,MO,Vernon County,29,217,29217,Chiefs,#e31837,20826,1706,6526,8576,0.198927239,0.760960821,-4820,4820,-0.562033582,0.562033582
Missouri,MO,Warren County,29,219,29219,Rams,#b3995d,33513,3915,11109,15766,0.248319168,0.704617531,-7194,7194,-0.456298364,0.456298364
Missouri,MO,Washington County,29,221,29221,Rams,#b3995d,24788,1926,7047,9279,0.20756547,0.759456838,-5121,5121,-0.551891368,0.551891368
Missouri,MO,Wayne County,29,223,29223,Rams,#b3995d,13405,946,4640,5738,0.164865807,0.808644127,-3694,3694,-0.64377832,0.64377832
Missouri,MO,Webster County,29,225,29225,Chiefs,#e31837,37483,3173,12829,16690,0.190113841,0.768663871,-9656,9656,-0.57855003,0.57855003
Missouri,MO,Worth County,29,227,29227,Chiefs,#e31837,2057,195,808,1046,0.186424474,0.772466539,-613,613,-0.586042065,0.586042065
Missouri,MO,Wright County,29,229,29229,Chiefs,#e31837,18268,1166,6703,8086,0.144199852,0.828963641,-5537,5537,-0.684763789,0.684763789
Missouri,MO,St. Louis city,29,510,29510,Rams,#b3995d,315685,101487,20281,127403,0.796582498,0.159187774,81206,-81206,0.637394724,-0.637394724
Montana,MT,Beaverhead County,30,1,30001,Broncos,#fb4f14,9300,1115,3243,4676,0.238451668,0.693541488,-2128,2128,-0.45508982,0.45508982
Montana,MT,Big Horn County,30,3,30003,Broncos,#fb4f14,13242,2061,1833,4148,0.496865959,0.441899711,228,-228,0.054966249,-0.054966249
Montana,MT,Blaine County,30,5,30005,Broncos,#fb4f14,6577,1187,1259,2621,0.45288058,0.480351011,-72,72,-0.027470431,0.027470431
Montana,MT,Broadwater County,30,7,30007,Broncos,#fb4f14,5689,566,2329,3097,0.182757507,0.752018082,-1763,1763,-0.569260575,0.569260575
Montana,MT,Carbon County,30,9,30009,Broncos,#fb4f14,10408,1824,3729,5923,0.307952051,0.629579605,-1905,1905,-0.321627554,0.321627554
Montana,MT,Carter County,30,11,30011,Cowboys,#002244,1180,70,677,777,0.09009009,0.871299871,-607,607,-0.781209781,0.781209781
Montana,MT,Cascade County,30,13,30013,Broncos,#fb4f14,82278,12053,19343,33791,0.35669261,0.572430529,-7290,7290,-0.215737918,0.215737918
Montana,MT,Chouteau County,30,15,30015,Cowboys,#002244,5767,729,1676,2571,0.283547258,0.651886426,-947,947,-0.368339168,0.368339168
Montana,MT,Custer County,30,17,30017,Broncos,#fb4f14,12135,1172,3638,5145,0.227793975,0.707094266,-2466,2466,-0.479300292,0.479300292
Montana,MT,Daniels County,30,19,30019,Broncos,#fb4f14,1760,167,729,952,0.175420168,0.765756303,-562,562,-0.590336134,0.590336134
Montana,MT,Dawson County,30,21,30021,Broncos,#fb4f14,9625,786,3298,4297,0.182918315,0.767512218,-2512,2512,-0.584593903,0.584593903
Montana,MT,Deer Lodge County,30,23,30023,Seahawks,#69be28,9139,2018,1736,4099,0.492315199,0.423517931,282,-282,0.068797268,-0.068797268
Montana,MT,Fallon County,30,25,30025,Broncos,#fb4f14,3190,154,1276,1474,0.104477612,0.865671642,-1122,1122,-0.76119403,0.76119403
Montana,MT,Fergus County,30,27,30027,Broncos,#fb4f14,11427,1196,4235,5782,0.206848841,0.732445521,-3039,3039,-0.525596679,0.525596679
Montana,MT,Flathead County,30,29,30029,Seahawks,#69be28,96165,13233,30079,46144,0.286776179,0.651850728,-16846,16846,-0.365074549,0.365074549
Montana,MT,Gallatin County,30,31,30031,Broncos,#fb4f14,100739,23879,23360,52169,0.457723936,0.447775499,519,-519,0.009948437,-0.009948437
Montana,MT,Garfield County,30,33,30033,Broncos,#fb4f14,1314,34,653,715,0.047552448,0.913286713,-619,619,-0.865734266,0.865734266
Montana,MT,Glacier County,30,35,30035,Seahawks,#69be28,13647,3076,1598,4969,0.619038036,0.321593882,1478,-1478,0.297444154,-0.297444154
Montana,MT,Golden Valley County,30,37,30037,Broncos,#fb4f14,827,71,365,468,0.151709402,0.77991453,-294,294,-0.628205128,0.628205128
Montana,MT,Granite County,30,39,30039,Seahawks,#69be28,3240,469,1185,1762,0.266174801,0.672531215,-716,716,-0.406356413,0.406356413
Montana,MT,Hill County,30,41,30041,Broncos,#fb4f14,16572,2350,3446,6347,0.370253663,0.542933669,-1096,1096,-0.172680006,0.172680006
Montana,MT,Jefferson County,30,43,30043,Broncos,#fb4f14,11645,1975,4099,6535,0.302218822,0.62723795,-2124,2124,-0.325019128,0.325019128
Montana,MT,Judith Basin County,30,45,30045,Packers,#203731,1926,232,867,1189,0.195121951,0.729184188,-635,635,-0.534062237,0.534062237
Montana,MT,Lake County,30,47,30047,Seahawks,#69be28,29457,4703,7453,12898,0.364630175,0.577841526,-2750,2750,-0.213211351,0.213211351
Montana,MT,Lewis and Clark County,30,49,30049,Seahawks,#69be28,66418,14331,16665,33697,0.425290085,0.494554411,-2334,2334,-0.069264326,0.069264326
Montana,MT,Liberty County,30,51,30051,Broncos,#fb4f14,2408,205,695,949,0.21601686,0.732349842,-490,490,-0.516332982,0.516332982
Montana,MT,Lincoln County,30,53,30053,Seahawks,#69be28,19052,2040,6720,9250,0.220540541,0.726486486,-4680,4680,-0.505945946,0.505945946
Montana,MT,McCone County,30,55,30055,Cowboys,#002244,1683,154,858,1056,0.145833333,0.8125,-704,704,-0.666666667,0.666666667
Montana,MT,Madison County,30,57,30057,Broncos,#fb4f14,7915,1175,3280,4708,0.249575191,0.696686491,-2105,2105,-0.4471113,0.4471113
Montana,MT,Meagher County,30,59,30059,Broncos,#fb4f14,1830,191,728,970,0.196907216,0.750515464,-537,537,-0.553608247,0.553608247
Montana,MT,Mineral County,30,61,30061,Seahawks,#69be28,4251,515,1322,1974,0.260891591,0.66970618,-807,807,-0.40881459,0.40881459
Montana,MT,Missoula County,30,63,30063,Seahawks,#69be28,114181,30740,21699,57271,0.536746346,0.378882855,9041,-9041,0.157863491,-0.157863491
Montana,MT,Musselshell County,30,65,30065,Broncos,#fb4f14,4582,331,1961,2404,0.137687188,0.815723794,-1630,1630,-0.678036606,0.678036606
Montana,MT,Park County,30,67,30067,Broncos,#fb4f14,15972,3521,4872,9056,0.388803004,0.537985866,-1351,1351,-0.149182862,0.149182862
Montana,MT,Petroleum County,30,69,30069,Packers,#203731,475,30,276,319,0.094043887,0.865203762,-246,246,-0.771159875,0.771159875
Montana,MT,Phillips County,30,71,30071,Broncos,#fb4f14,4169,315,1715,2147,0.146716348,0.798789008,-1400,1400,-0.65207266,0.65207266
Montana,MT,Pondera County,30,73,30073,Seahawks,#69be28,6184,737,1786,2692,0.273774146,0.663447251,-1049,1049,-0.389673105,0.389673105
Montana,MT,Powder River County,30,75,30075,Broncos,#fb4f14,1773,127,880,1047,0.121298949,0.840496657,-753,753,-0.719197708,0.719197708
Montana,MT,Powell County,30,77,30077,Seahawks,#69be28,6840,549,2017,2768,0.19833815,0.728684971,-1468,1468,-0.530346821,0.530346821
Montana,MT,Prairie County,30,79,30079,Broncos,#fb4f14,1160,100,555,686,0.145772595,0.809037901,-455,455,-0.663265306,0.663265306
Montana,MT,Ravalli County,30,81,30081,Seahawks,#69be28,41373,6166,14673,22063,0.27947242,0.665050084,-8507,8507,-0.385577664,0.385577664
Montana,MT,Richland County,30,83,30083,Broncos,#fb4f14,11960,669,3885,4812,0.139027431,0.807356608,-3216,3216,-0.668329177,0.668329177
Montana,MT,Roosevelt County,30,85,30085,Broncos,#fb4f14,11476,1504,1722,3486,0.431440046,0.493975904,-218,218,-0.062535858,0.062535858
Montana,MT,Rosebud County,30,87,30087,Broncos,#fb4f14,9398,969,2211,3357,0.288650581,0.658623771,-1242,1242,-0.36997319,0.36997319
Montana,MT,Sanders County,30,89,30089,Seahawks,#69be28,11336,1211,4268,5871,0.206268097,0.726963039,-3057,3057,-0.520694941,0.520694941
Montana,MT,Sheridan County,30,91,30091,Vikings,#4f2683,3687,476,1237,1825,0.260821918,0.677808219,-761,761,-0.416986301,0.416986301
Montana,MT,Silver Bow County,30,93,30093,Broncos,#fb4f14,34622,8545,6252,16122,0.530021089,0.387793078,2293,-2293,0.142228011,-0.142228011
Montana,MT,Stillwater County,30,95,30095,Broncos,#fb4f14,9486,904,3630,4816,0.187707641,0.753737542,-2726,2726,-0.5660299,0.5660299
Montana,MT,Sweet Grass County,30,97,30097,Broncos,#fb4f14,3634,398,1580,2077,0.191622532,0.760712566,-1182,1182,-0.569090034,0.569090034
Montana,MT,Teton County,30,99,30099,Broncos,#fb4f14,6104,803,2152,3143,0.255488387,0.68469615,-1349,1349,-0.429207763,0.429207763
Montana,MT,Toole County,30,101,30101,Seahawks,#69be28,5087,399,1495,2018,0.197720515,0.740832507,-1096,1096,-0.543111992,0.543111992
Montana,MT,Treasure County,30,103,30103,Broncos,#fb4f14,697,59,350,441,0.133786848,0.793650794,-291,291,-0.659863946,0.659863946
Montana,MT,Valley County,30,105,30105,Broncos,#fb4f14,7659,886,2697,3860,0.229533679,0.698704663,-1811,1811,-0.469170984,0.469170984
Montana,MT,Wheatland County,30,107,30107,Broncos,#fb4f14,2110,179,698,932,0.192060086,0.748927039,-519,519,-0.556866953,0.556866953
Montana,MT,Wibaux County,30,109,30109,Broncos,#fb4f14,1130,55,460,533,0.103189493,0.8630394,-405,405,-0.759849906,0.759849906
Montana,MT,Yellowstone County,30,111,30111,Broncos,#fb4f14,157048,21117,38675,64675,0.32650947,0.59798995,-17558,17558,-0.271480479,0.271480479
Nebraska,NE,Adams County,31,1,31001,Broncos,#fb4f14,31587,3272,9205,13172,0.248405709,0.698830853,-5933,5933,-0.450425144,0.450425144
Nebraska,NE,Antelope County,31,3,31003,Broncos,#fb4f14,6414,381,2717,3220,0.118322981,0.84378882,-2336,2336,-0.725465839,0.725465839
Nebraska,NE,Arthur County,31,5,31005,Broncos,#fb4f14,456,16,237,263,0.060836502,0.901140684,-221,221,-0.840304183,0.840304183
Nebraska,NE,Banner County,31,7,31007,Broncos,#fb4f14,788,18,355,390,0.046153846,0.91025641,-337,337,-0.864102564,0.864102564
Nebraska,NE,Blaine County,31,9,31009,Broncos,#fb4f14,487,30,273,313,0.095846645,0.872204473,-243,243,-0.776357827,0.776357827
Nebraska,NE,Boone County,31,11,31011,Packers,#203731,5315,414,2299,2867,0.144401814,0.801883502,-1885,1885,-0.657481688,0.657481688
Nebraska,NE,Box Butte County,31,13,31013,Broncos,#fb4f14,11337,953,3550,4761,0.200168032,0.745641672,-2597,2597,-0.54547364,0.54547364
Nebraska,NE,Boyd County,31,15,31015,Broncos,#fb4f14,2006,128,978,1142,0.112084063,0.856392294,-850,850,-0.744308231,0.744308231
Nebraska,NE,Brown County,31,17,31017,Broncos,#fb4f14,2946,153,1380,1579,0.09689677,0.873970868,-1227,1227,-0.777074098,0.777074098
Nebraska,NE,Buffalo County,31,19,31019,Broncos,#fb4f14,48863,4690,14424,20477,0.229037457,0.704400059,-9734,9734,-0.475362602,0.475362602
Nebraska,NE,Burt County,31,21,31021,Packers,#203731,6585,928,2360,3523,0.263411865,0.669883622,-1432,1432,-0.406471757,0.406471757
Nebraska,NE,Butler County,31,23,31023,Packers,#203731,8115,690,3068,3914,0.17629024,0.783852836,-2378,2378,-0.607562596,0.607562596
Nebraska,NE,Cass County,31,25,31025,Packers,#203731,25512,3461,8388,12609,0.274486478,0.665239115,-4927,4927,-0.390752637,0.390752637
Nebraska,NE,Cedar County,31,27,31027,Packers,#203731,8564,572,3533,4360,0.131192661,0.810321101,-2961,2961,-0.67912844,0.67912844
Nebraska,NE,Chase County,31,29,31029,Broncos,#fb4f14,3956,171,1621,1851,0.092382496,0.875742842,-1450,1450,-0.783360346,0.783360346
Nebraska,NE,Cherry County,31,31,31031,Broncos,#fb4f14,5848,317,2623,3082,0.102855289,0.851070733,-2306,2306,-0.748215445,0.748215445
Nebraska,NE,Cheyenne County,31,33,31033,Broncos,#fb4f14,10167,702,3610,4569,0.153644123,0.790107244,-2908,2908,-0.636463121,0.636463121
Nebraska,NE,Clay County,31,35,31035,Broncos,#fb4f14,6309,470,2373,2973,0.158089472,0.798183653,-1903,1903,-0.640094181,0.640094181
Nebraska,NE,Colfax County,31,37,31037,Packers,#203731,10520,857,2171,3172,0.270176545,0.68442623,-1314,1314,-0.414249685,0.414249685
Nebraska,NE,Cuming County,31,39,31039,Broncos,#fb4f14,9125,712,3095,3988,0.178535607,0.776078235,-2383,2383,-0.597542628,0.597542628
Nebraska,NE,Custer County,31,41,31041,Broncos,#fb4f14,10806,635,4616,5489,0.115685917,0.840954637,-3981,3981,-0.725268719,0.725268719
Nebraska,NE,Dakota County,31,43,31043,Cowboys,#002244,20781,2904,4028,7259,0.400055104,0.554897369,-1124,1124,-0.154842265,0.154842265
Nebraska,NE,Dawes County,31,45,31045,Broncos,#fb4f14,9055,785,2559,3578,0.219396311,0.715204025,-1774,1774,-0.495807714,0.495807714
Nebraska,NE,Dawson County,31,47,31047,Broncos,#fb4f14,23886,2116,5935,8486,0.249351874,0.699387226,-3819,3819,-0.450035352,0.450035352
Nebraska,NE,Deuel County,31,49,31049,Broncos,#fb4f14,1921,120,809,977,0.122824974,0.828045036,-689,689,-0.705220061,0.705220061
Nebraska,NE,Dixon County,31,51,31051,Packers,#203731,5797,556,2041,2744,0.202623907,0.743804665,-1485,1485,-0.541180758,0.541180758
Nebraska,NE,Dodge County,31,53,31053,Packers,#203731,36706,4451,9736,14959,0.297546627,0.650845645,-5285,5285,-0.353299017,0.353299017
Nebraska,NE,Douglas County,31,55,31055,Packers,#203731,550064,105207,102151,219531,0.479235279,0.465314694,3056,-3056,0.013920585,-0.013920585
Nebraska,NE,Dundy County,31,57,31057,Broncos,#fb4f14,1799,89,823,949,0.093782929,0.867228662,-734,734,-0.773445732,0.773445732
Nebraska,NE,Fillmore County,31,59,31059,Broncos,#fb4f14,5619,610,2100,2879,0.211879125,0.729419937,-1490,1490,-0.517540813,0.517540813
Nebraska,NE,Franklin County,31,61,31061,Broncos,#fb4f14,2985,250,1345,1656,0.150966184,0.812198068,-1095,1095,-0.661231884,0.661231884
Nebraska,NE,Frontier County,31,63,31063,Broncos,#fb4f14,2624,161,1106,1310,0.122900763,0.844274809,-945,945,-0.721374046,0.721374046
Nebraska,NE,Furnas County,31,65,31065,Broncos,#fb4f14,4862,304,1915,2315,0.131317495,0.827213823,-1611,1611,-0.695896328,0.695896328
Nebraska,NE,Gage County,31,67,31067,Chiefs,#e31837,21900,2930,6333,9854,0.297341181,0.642683174,-3403,3403,-0.345341993,0.345341993
Nebraska,NE,Garden County,31,69,31069,Broncos,#fb4f14,1918,153,869,1063,0.143932267,0.817497648,-716,716,-0.673565381,0.673565381
Nebraska,NE,Garfield County,31,71,31071,Packers,#203731,2028,121,819,968,0.125,0.84607438,-698,698,-0.72107438,0.72107438
Nebraska,NE,Gosper County,31,73,31073,Broncos,#fb4f14,1973,165,792,1000,0.165,0.792,-627,627,-0.627,0.627
Nebraska,NE,Grant County,31,75,31075,Broncos,#fb4f14,641,20,367,394,0.050761421,0.931472081,-347,347,-0.88071066,0.88071066
Nebraska,NE,Greeley County,31,77,31077,Packers,#203731,2429,210,911,1165,0.180257511,0.781974249,-701,701,-0.601716738,0.601716738
Nebraska,NE,Hall County,31,79,31079,Broncos,#fb4f14,61680,6142,14139,21331,0.287937743,0.662838123,-7997,7997,-0.37490038,0.37490038
Nebraska,NE,Hamilton County,31,81,31081,Broncos,#fb4f14,9190,873,3763,4902,0.178090575,0.767645859,-2890,2890,-0.589555284,0.589555284
Nebraska,NE,Harlan County,31,83,31083,Broncos,#fb4f14,3452,219,1302,1582,0.138432364,0.82300885,-1083,1083,-0.684576485,0.684576485
Nebraska,NE,Hayes County,31,85,31085,Broncos,#fb4f14,932,30,471,510,0.058823529,0.923529412,-441,441,-0.864705882,0.864705882
Nebraska,NE,Hitchcock County,31,87,31087,Broncos,#fb4f14,2883,158,1216,1440,0.109722222,0.844444444,-1058,1058,-0.734722222,0.734722222
Nebraska,NE,Holt County,31,89,31089,Packers,#203731,10313,522,4275,4979,0.104840329,0.858606146,-3753,3753,-0.753765816,0.753765816
Nebraska,NE,Hooker County,31,91,31091,Broncos,#fb4f14,732,40,355,414,0.096618357,0.857487923,-315,315,-0.760869565,0.760869565
Nebraska,NE,Howard County,31,93,31093,Broncos,#fb4f14,6409,544,2284,2958,0.183908046,0.77214334,-1740,1740,-0.588235294,0.588235294
Nebraska,NE,Jefferson County,31,95,31095,Chiefs,#e31837,7263,831,2387,3430,0.242274052,0.695918367,-1556,1556,-0.453644315,0.453644315
Nebraska,NE,Johnson County,31,97,31097,Chiefs,#e31837,5173,560,1348,2051,0.273037543,0.657240371,-788,788,-0.384202828,0.384202828
Nebraska,NE,Kearney County,31,99,31099,Broncos,#fb4f14,6585,550,2519,3242,0.169648365,0.776989513,-1969,1969,-0.607341147,0.607341147
Nebraska,NE,Keith County,31,101,31101,Broncos,#fb4f14,8063,560,3203,3945,0.141951838,0.811913815,-2643,2643,-0.669961977,0.669961977
Nebraska,NE,Keya Paha County,31,103,31103,Broncos,#fb4f14,804,39,458,514,0.075875486,0.891050584,-419,419,-0.815175097,0.815175097
Nebraska,NE,Kimball County,31,105,31105,Broncos,#fb4f14,3689,227,1317,1636,0.138753056,0.805012225,-1090,1090,-0.666259169,0.666259169
Nebraska,NE,Knox County,31,107,31107,Broncos,#fb4f14,8543,715,3181,4061,0.176065009,0.783304605,-2466,2466,-0.607239596,0.607239596
Nebraska,NE,Lancaster County,31,109,31109,Broncos,#fb4f14,306468,60533,60456,129803,0.466345154,0.465751947,77,-77,0.000593207,-0.000593207
Nebraska,NE,Lincoln County,31,111,31111,Broncos,#fb4f14,35656,2878,11992,15674,0.18361618,0.765088682,-9114,9114,-0.581472502,0.581472502
Nebraska,NE,Logan County,31,113,31113,Broncos,#fb4f14,777,32,400,451,0.070953437,0.88691796,-368,368,-0.815964523,0.815964523
Nebraska,NE,Loup County,31,115,31115,Broncos,#fb4f14,585,48,323,382,0.12565445,0.845549738,-275,275,-0.719895288,0.719895288
Nebraska,NE,McPherson County,31,117,31117,Broncos,#fb4f14,475,14,257,286,0.048951049,0.898601399,-243,243,-0.84965035,0.84965035
Nebraska,NE,Madison County,31,119,31119,Packers,#203731,35039,2663,10518,13956,0.190813987,0.753654342,-7855,7855,-0.562840355,0.562840355
Nebraska,NE,Merrick County,31,121,31121,Broncos,#fb4f14,7787,601,2914,3707,0.162125708,0.786080388,-2313,2313,-0.62395468,0.62395468
Nebraska,NE,Morrill County,31,123,31123,Broncos,#fb4f14,4854,282,1788,2166,0.130193906,0.825484765,-1506,1506,-0.695290859,0.695290859
Nebraska,NE,Nance County,31,125,31125,Broncos,#fb4f14,3595,280,1257,1599,0.175109443,0.786116323,-977,977,-0.611006879,0.611006879
Nebraska,NE,Nemaha County,31,127,31127,Chiefs,#e31837,7046,765,2068,3035,0.252059308,0.681383855,-1303,1303,-0.429324547,0.429324547
Nebraska,NE,Nuckolls County,31,129,31129,Broncos,#fb4f14,4329,348,1709,2153,0.161634928,0.793776126,-1361,1361,-0.632141198,0.632141198
Nebraska,NE,Otoe County,31,131,31131,Chiefs,#e31837,15984,2017,4833,7279,0.277098503,0.66396483,-2816,2816,-0.386866328,0.386866328
Nebraska,NE,Pawnee County,31,133,31133,Chiefs,#e31837,2659,279,970,1314,0.212328767,0.738203957,-691,691,-0.52587519,0.52587519
Nebraska,NE,Perkins County,31,135,31135,Broncos,#fb4f14,2944,160,1202,1418,0.112834979,0.847672779,-1042,1042,-0.7348378,0.7348378
Nebraska,NE,Phelps County,31,137,31137,Broncos,#fb4f14,9296,571,3832,4609,0.123888045,0.831416793,-3261,3261,-0.707528748,0.707528748
Nebraska,NE,Pierce County,31,139,31139,Packers,#203731,7208,382,3052,3580,0.106703911,0.852513966,-2670,2670,-0.745810056,0.745810056
Nebraska,NE,Platte County,31,141,31141,Broncos,#fb4f14,32847,2612,10864,14047,0.185947177,0.773403574,-8252,8252,-0.587456396,0.587456396
Nebraska,NE,Polk County,31,143,31143,Packers,#203731,5202,411,2019,2538,0.161938534,0.795508274,-1608,1608,-0.63356974,0.63356974
Nebraska,NE,Red Willow County,31,145,31145,Broncos,#fb4f14,10829,638,4212,5061,0.126062043,0.832246592,-3574,3574,-0.706184549,0.706184549
Nebraska,NE,Richardson County,31,147,31147,Chiefs,#e31837,8094,798,2684,3666,0.217675941,0.732133115,-1886,1886,-0.514457174,0.514457174
Nebraska,NE,Rock County,31,149,31149,Packers,#203731,1381,70,687,793,0.088272383,0.866330391,-617,617,-0.778058008,0.778058008
Nebraska,NE,Saline County,31,151,31151,Broncos,#fb4f14,14282,1630,2849,4795,0.339937435,0.594160584,-1219,1219,-0.254223149,0.254223149
Nebraska,NE,Sarpy County,31,153,31153,Packers,#203731,175692,27704,44649,77781,0.35617953,0.57403479,-16945,16945,-0.21785526,0.21785526
Nebraska,NE,Saunders County,31,155,31155,Packers,#203731,21016,2509,7486,10598,0.236742782,0.706359691,-4977,4977,-0.469616909,0.469616909
Nebraska,NE,Scotts Bluff County,31,157,31157,Broncos,#fb4f14,36261,3151,9952,13895,0.22677222,0.716228859,-6801,6801,-0.489456639,0.489456639
Nebraska,NE,Seward County,31,159,31159,Packers,#203731,17110,1881,5451,7754,0.242584473,0.702992004,-3570,3570,-0.460407532,0.460407532
Nebraska,NE,Sheridan County,31,161,31161,Broncos,#fb4f14,5220,286,2192,2565,0.111500975,0.854580897,-1906,1906,-0.743079922,0.743079922
Nebraska,NE,Sherman County,31,163,31163,Broncos,#fb4f14,3091,338,1143,1553,0.217643271,0.735994849,-805,805,-0.518351578,0.518351578
Nebraska,NE,Sioux County,31,165,31165,Broncos,#fb4f14,1260,77,602,709,0.108603667,0.849083216,-525,525,-0.740479549,0.740479549
Nebraska,NE,Stanton County,31,167,31167,Packers,#203731,5937,417,2173,2748,0.151746725,0.790756914,-1756,1756,-0.639010189,0.639010189
Nebraska,NE,Thayer County,31,169,31169,Broncos,#fb4f14,5163,490,1993,2613,0.187523919,0.762724837,-1503,1503,-0.575200918,0.575200918
Nebraska,NE,Thomas County,31,171,31171,Broncos,#fb4f14,684,30,344,387,0.07751938,0.888888889,-314,314,-0.811369509,0.811369509
Nebraska,NE,Thurston County,31,173,31173,Broncos,#fb4f14,7064,911,1013,2029,0.44898965,0.49926072,-102,102,-0.050271069,0.050271069
Nebraska,NE,Valley County,31,175,31175,Broncos,#fb4f14,4154,337,1770,2172,0.155156538,0.814917127,-1433,1433,-0.659760589,0.659760589
Nebraska,NE,Washington County,31,177,31177,Packers,#203731,20248,2606,7374,10584,0.246220711,0.696712018,-4768,4768,-0.450491308,0.450491308
Nebraska,NE,Wayne County,31,179,31179,Packers,#203731,9367,828,2675,3740,0.221390374,0.715240642,-1847,1847,-0.493850267,0.493850267
Nebraska,NE,Webster County,31,181,31181,Broncos,#fb4f14,3625,306,1320,1687,0.181387078,0.78245406,-1014,1014,-0.601066983,0.601066983
Nebraska,NE,Wheeler County,31,183,31183,Packers,#203731,750,62,377,459,0.135076253,0.821350763,-315,315,-0.68627451,0.68627451
Nebraska,NE,York County,31,185,31185,Broncos,#fb4f14,13806,1181,4686,6256,0.188778772,0.749040921,-3505,3505,-0.560262148,0.560262148
Nevada,NV,Churchill County,32,1,32001,49ers,#aa0000,24200,2210,7828,10936,0.202084857,0.715801024,-5618,5618,-0.513716167,0.513716167
Nevada,NV,Clark County,32,3,32003,Cowboys,#002244,2114801,401068,319571,765421,0.523983533,0.417510102,81497,-81497,0.106473431,-0.106473431
Nevada,NV,Douglas County,32,5,32005,49ers,#aa0000,47710,8453,17406,27871,0.303290158,0.624520111,-8953,8953,-0.321229952,0.321229952
Nevada,NV,Elko County,32,7,32007,Broncos,#fb4f14,51935,3400,13542,18545,0.183337827,0.73022378,-10142,10142,-0.546885953,0.546885953
Nevada,NV,Esmeralda County,32,9,32009,Cowboys,#002244,829,65,329,423,0.153664303,0.777777778,-264,264,-0.624113475,0.624113475
Nevada,NV,Eureka County,32,11,32011,Cowboys,#002244,2016,74,723,854,0.086651054,0.846604215,-649,649,-0.759953162,0.759953162
Nevada,NV,Humboldt County,32,13,32013,49ers,#aa0000,17019,1386,4521,6433,0.215451578,0.702782528,-3135,3135,-0.48733095,0.48733095
Nevada,NV,Lander County,32,15,32015,Cowboys,#002244,5903,403,1828,2413,0.167012018,0.757563199,-1425,1425,-0.590551181,0.590551181
Nevada,NV,Lincoln County,32,17,32017,Cowboys,#002244,5036,285,1671,2132,0.133677298,0.783771107,-1386,1386,-0.650093809,0.650093809
Nevada,NV,Lyon County,32,19,32019,49ers,#aa0000,52585,6146,16005,23762,0.258648262,0.673554415,-9859,9859,-0.414906153,0.414906153
Nevada,NV,Mineral County,32,21,32021,49ers,#aa0000,4478,637,1179,1997,0.318978468,0.590385578,-542,542,-0.271407111,0.271407111
Nevada,NV,Nye County,32,23,32023,Cowboys,#002244,42477,5095,13320,19592,0.260055125,0.679869334,-8225,8225,-0.41981421,0.41981421
Nevada,NV,Pershing County,32,27,32027,49ers,#aa0000,6634,430,1403,1982,0.216952573,0.707870838,-973,973,-0.490918264,0.490918264
Nevada,NV,Storey County,32,29,32029,49ers,#aa0000,3987,752,1616,2558,0.293979672,0.63174355,-864,864,-0.337763878,0.337763878
Nevada,NV,Washoe County,32,31,32031,49ers,#aa0000,446903,97032,94529,209282,0.463642358,0.451682419,2503,-2503,0.011959939,-0.011959939
Nevada,NV,White Pine County,32,33,32033,Cowboys,#002244,9811,707,2723,3773,0.187384045,0.721706865,-2016,2016,-0.53432282,0.53432282
Nevada,NV,Carson City,32,510,32510,49ers,#aa0000,54521,9610,13125,25016,0.384154141,0.524664215,-3515,3515,-0.140510074,0.140510074
New Hampshire,NH,Belknap County,33,1,33001,Patriots,#c60c30,60641,13517,19315,34462,0.392229122,0.560472404,-5798,5798,-0.168243282,0.168243282
New Hampshire,NH,Carroll County,33,3,33003,Patriots,#c60c30,47285,12987,14635,29063,0.446856828,0.503561229,-1648,1648,-0.056704401,0.056704401
New Hampshire,NH,Cheshire County,33,5,33005,Patriots,#c60c30,75909,22064,16876,41080,0.537098345,0.410808179,5188,-5188,0.126290166,-0.126290166
New Hampshire,NH,Coos County,33,7,33007,Patriots,#c60c30,31212,6558,7951,15255,0.429891839,0.521206162,-1393,1393,-0.091314323,0.091314323
New Hampshire,NH,Grafton County,33,9,33009,Patriots,#c60c30,89320,28510,19010,50065,0.569459702,0.379706382,9500,-9500,0.189753321,-0.189753321
New Hampshire,NH,Hillsborough County,33,11,33011,Patriots,#c60c30,406678,99589,100013,210622,0.472832847,0.474845933,-424,424,-0.002013085,0.002013085
New Hampshire,NH,Merrimack County,33,13,33013,Patriots,#c60c30,147994,40198,37674,81982,0.490327145,0.459539899,2524,-2524,0.030787246,-0.030787246
New Hampshire,NH,Rockingham County,33,15,33015,Patriots,#c60c30,301777,79994,90447,179005,0.446881372,0.505276389,-10453,10453,-0.058395017,0.058395017
New Hampshire,NH,Strafford County,33,17,33017,Patriots,#c60c30,126825,34894,29072,67918,0.513766601,0.428045584,5822,-5822,0.085721017,-0.085721017
New Hampshire,NH,Sullivan County,33,19,33019,Patriots,#c60c30,42967,10210,10796,22101,0.461970047,0.488484684,-586,586,-0.026514637,0.026514637
New Jersey,NJ,Atlantic County,34,1,34001,Eagles,#004953,274219,54472,47882,105738,0.515160113,0.452836256,6590,-6590,0.062323857,-0.062323857
New Jersey,NJ,Bergen County,34,3,34003,Giants,#0b2265,938506,209251,163220,383965,0.544974151,0.425090829,46031,-46031,0.119883323,-0.119883323
New Jersey,NJ,Burlington County,34,5,34005,Eagles,#004953,450226,108361,79539,194988,0.555731635,0.40791741,28822,-28822,0.147814224,-0.147814224
New Jersey,NJ,Camden County,34,7,34007,Eagles,#004953,510923,142375,71020,220437,0.645876146,0.322178219,71355,-71355,0.323697927,-0.323697927
New Jersey,NJ,Cape May County,34,9,34009,Eagles,#004953,94727,18626,28237,48375,0.385033592,0.583710594,-9611,9611,-0.198677003,0.198677003
New Jersey,NJ,Cumberland County,34,11,34011,Eagles,#004953,155854,27045,24213,53018,0.510109774,0.456693953,2832,-2832,0.053415821,-0.053415821
New Jersey,NJ,Essex County,34,13,34013,Giants,#0b2265,797434,231031,62059,299808,0.770596515,0.206995811,168972,-168972,0.563600704,-0.563600704
New Jersey,NJ,Gloucester County,34,15,34015,Eagles,#004953,291479,66355,66949,138388,0.479485215,0.483777495,-594,594,-0.00429228,0.00429228
New Jersey,NJ,Hudson County,34,17,34017,Giants,#0b2265,674836,149980,45615,201425,0.744594762,0.226461462,104365,-104365,0.5181333,-0.5181333
New Jersey,NJ,Hunterdon County,34,19,34019,Giants,#0b2265,125488,28797,38565,70582,0.407993539,0.546385764,-9768,9768,-0.138392225,0.138392225
New Jersey,NJ,Mercer County,34,21,34021,Eagles,#004953,371398,93721,42604,141332,0.663126539,0.30144624,51117,-51117,0.361680299,-0.361680299
New Jersey,NJ,Middlesex County,34,23,34023,Giants,#0b2265,840900,164887,108981,282668,0.583323899,0.385544172,55906,-55906,0.197779727,-0.197779727
New Jersey,NJ,Monmouth County,34,25,34025,Giants,#0b2265,628715,135825,165305,311474,0.436071711,0.530718455,-29480,29480,-0.094646744,0.094646744
New Jersey,NJ,Morris County,34,27,34027,Giants,#0b2265,499509,114437,125376,248848,0.459867067,0.503825628,-10939,10939,-0.043958561,0.043958561
New Jersey,NJ,Ocean County,34,29,34029,Giants,#0b2265,588721,81845,170103,259592,0.315283214,0.655270578,-88258,88258,-0.339987365,0.339987365
New Jersey,NJ,Passaic County,34,31,34031,Giants,#0b2265,510916,112608,71488,189099,0.595497596,0.378045362,41120,-41120,0.217452234,-0.217452234
New Jersey,NJ,Salem County,34,33,34033,Eagles,#004953,64180,11766,16256,29220,0.402669405,0.55633128,-4490,4490,-0.153661875,0.153661875
New Jersey,NJ,Somerset County,34,35,34035,Giants,#0b2265,333654,83839,64640,154249,0.543530266,0.419062684,19199,-19199,0.124467582,-0.124467582
New Jersey,NJ,Sussex County,34,37,34037,Giants,#0b2265,143673,24132,46486,73860,0.326726239,0.629379908,-22354,22354,-0.302653669,0.302653669
New Jersey,NJ,Union County,34,39,34039,Giants,#0b2265,555786,145412,67582,219385,0.66281651,0.308052055,77830,-77830,0.354764455,-0.354764455
New Jersey,NJ,Warren County,34,41,34041,Giants,#0b2265,106869,16991,29393,48442,0.35074935,0.606766855,-12402,12402,-0.256017505,0.256017505
New Mexico,NM,Bernalillo County,35,1,35001,Cowboys,#002244,676685,141960,93874,269861,0.526048595,0.347860565,48086,-48086,0.17818803,-0.17818803
New Mexico,NM,Catron County,35,3,35003,Cowboys,#002244,3456,426,1453,2024,0.210474308,0.717885375,-1027,1027,-0.507411067,0.507411067
New Mexico,NM,Chaves County,35,5,35005,Cowboys,#002244,65764,5530,12869,20159,0.274319163,0.638374919,-7339,7339,-0.364055757,0.364055757
New Mexico,NM,Cibola County,35,6,35006,Cowboys,#002244,27329,3721,3179,7975,0.466583072,0.39862069,542,-542,0.067962382,-0.067962382
New Mexico,NM,Colfax County,35,7,35007,Broncos,#fb4f14,12414,2118,2569,5271,0.401821286,0.487383798,-451,451,-0.085562512,0.085562512
New Mexico,NM,Curry County,35,9,35009,Cowboys,#002244,50398,2776,7560,11292,0.245837761,0.669500531,-4784,4784,-0.42366277,0.42366277
New Mexico,NM,De Baca County,35,11,35011,Cowboys,#002244,1828,192,617,903,0.212624585,0.683277962,-425,425,-0.470653378,0.470653378
New Mexico,NM,Dona Ana County,35,13,35013,Cowboys,#002244,214295,37543,25095,69324,0.541558479,0.361995846,12448,-12448,0.179562633,-0.179562633
New Mexico,NM,Eddy County,35,15,35015,Cowboys,#002244,57578,5008,13124,19523,0.256517953,0.672232751,-8116,8116,-0.415714798,0.415714798
New Mexico,NM,Grant County,35,17,35017,Cowboys,#002244,28609,6226,5251,12633,0.492836223,0.415657405,975,-975,0.077178817,-0.077178817
New Mexico,NM,Guadalupe County,35,19,35019,Cowboys,#002244,4371,962,591,1809,0.531785517,0.326699834,371,-371,0.205085683,-0.205085683
New Mexico,NM,Harding County,35,21,35021,Cowboys,#002244,698,156,311,527,0.29601518,0.590132827,-155,155,-0.294117647,0.294117647
New Mexico,NM,Hidalgo County,35,23,35023,Cowboys,#002244,4423,780,906,1836,0.424836601,0.493464052,-126,126,-0.068627451,0.068627451
New Mexico,NM,Lea County,35,25,35025,Cowboys,#002244,71180,3877,12306,17369,0.223213772,0.708503656,-8429,8429,-0.485289884,0.485289884
New Mexico,NM,Lincoln County,35,27,35027,Cowboys,#002244,19420,2329,5889,8856,0.262985547,0.6649729,-3560,3560,-0.401987353,0.401987353
New Mexico,NM,Los Alamos County,35,28,35028,Broncos,#fb4f14,17785,5443,3329,10430,0.521860019,0.319175455,2114,-2114,0.202684564,-0.202684564
New Mexico,NM,Luna County,35,29,35029,Cowboys,#002244,24518,3195,3478,7245,0.440993789,0.48005521,-283,283,-0.039061422,0.039061422
New Mexico,NM,McKinley County,35,31,35031,Cowboys,#002244,76708,13162,4893,20791,0.633062383,0.235342215,8269,-8269,0.397720167,-0.397720167
New Mexico,NM,Mora County,35,33,35033,Broncos,#fb4f14,4596,1533,662,2429,0.631123919,0.27254014,871,-871,0.358583779,-0.358583779
New Mexico,NM,Otero County,35,35,35035,Cowboys,#002244,64362,6033,11756,19636,0.307241801,0.598696272,-5723,5723,-0.291454471,0.291454471
New Mexico,NM,Quay County,35,37,35037,Cowboys,#002244,8455,1016,2208,3550,0.286197183,0.621971831,-1192,1192,-0.335774648,0.335774648
New Mexico,NM,Rio Arriba County,35,39,35039,Broncos,#fb4f14,39465,9534,3583,14767,0.645628767,0.242635606,5951,-5951,0.40299316,-0.40299316
New Mexico,NM,Roosevelt County,35,41,35041,Cowboys,#002244,19120,1445,3865,5855,0.246797609,0.660119556,-2420,2420,-0.413321947,0.413321947
New Mexico,NM,Sandoval County,35,43,35043,Cowboys,#002244,139394,27405,25748,60597,0.452250111,0.424905523,1657,-1657,0.027344588,-0.027344588
New Mexico,NM,San Juan County,35,45,35045,Broncos,#fb4f14,118737,12826,27879,45476,0.282038878,0.613048641,-15053,15053,-0.331009763,0.331009763
New Mexico,NM,San Miguel County,35,47,35047,Broncos,#fb4f14,27967,7249,2302,10662,0.679891202,0.215906959,4947,-4947,0.463984243,-0.463984243
New Mexico,NM,Santa Fe County,35,49,35049,Cowboys,#002244,148686,49956,14198,70082,0.712822123,0.20259125,35758,-35758,0.510230872,-0.510230872
New Mexico,NM,Sierra County,35,51,35051,Cowboys,#002244,11282,1600,2998,5129,0.311951647,0.584519399,-1398,1398,-0.272567752,0.272567752
New Mexico,NM,Socorro County,35,53,35053,Cowboys,#002244,17256,3275,2592,6756,0.484754292,0.38365897,683,-683,0.101095323,-0.101095323
New Mexico,NM,Taos County,35,55,35055,Broncos,#fb4f14,32907,10550,2706,15072,0.699973461,0.179538217,7844,-7844,0.520435244,-0.520435244
New Mexico,NM,Torrance County,35,57,35057,Cowboys,#002244,15485,1770,3695,6250,0.2832,0.5912,-1925,1925,-0.308,0.308
New Mexico,NM,Union County,35,59,35059,Cowboys,#002244,4201,318,1214,1688,0.188388626,0.719194313,-896,896,-0.530805687,0.530805687
New Mexico,NM,Valencia County,35,61,35061,Cowboys,#002244,75737,10810,13175,27350,0.395246801,0.481718464,-2365,2365,-0.086471664,0.086471664
New York,NY,Albany County,36,1,36001,Giants,#0b2265,309381,74775,44227,125644,0.59513387,0.352002483,30548,-30548,0.243131387,-0.243131387
New York,NY,Allegany County,36,3,36003,Bills,#00338d,47462,4473,11712,17111,0.261410788,0.684471977,-7239,7239,-0.423061189,0.423061189
New York,NY,Bronx County,36,5,36005,Giants,#0b2265,1455444,318403,34424,358857,0.88726986,0.09592679,283979,-283979,0.79134307,-0.79134307
New York,NY,Broome County,36,7,36007,Giants,#0b2265,196567,35212,38077,77657,0.453429826,0.49032283,-2865,2865,-0.036893004,0.036893004
New York,NY,Cattaraugus County,36,9,36009,Bills,#00338d,77922,8717,18668,28961,0.300990988,0.644591002,-9951,9951,-0.343600014,0.343600014
New York,NY,Cayuga County,36,11,36011,Giants,#0b2265,78288,12202,16194,30124,0.405059089,0.537578011,-3992,3992,-0.132518922,0.132518922
New York,NY,Chautauqua County,36,13,36013,Bills,#00338d,130779,17281,29418,49381,0.349952411,0.595735202,-12137,12137,-0.245782791,0.245782791
New York,NY,Chemung County,36,15,36015,Giants,#0b2265,87071,12394,19025,33195,0.373369483,0.573128483,-6631,6631,-0.199759,0.199759
New York,NY,Chenango County,36,17,36017,Giants,#0b2265,48844,5943,11024,18113,0.328106885,0.60862364,-5081,5081,-0.280516756,0.280516756
New York,NY,Clinton County,36,19,36019,Giants,#0b2265,81251,13446,13181,28378,0.473817746,0.464479526,265,-265,0.00933822,-0.00933822
New York,NY,Columbia County,36,21,36021,Giants,#0b2265,61509,13123,12756,27255,0.481489635,0.468024216,367,-367,0.013465419,-0.013465419
New York,NY,Cortland County,36,23,36023,Giants,#0b2265,48494,7976,9207,18424,0.432913591,0.499728615,-1231,1231,-0.066815024,0.066815024
New York,NY,Delaware County,36,25,36025,Giants,#0b2265,46053,5825,11012,17778,0.327652154,0.619417257,-5187,5187,-0.291765103,0.291765103
New York,NY,Dutchess County,36,27,36027,Giants,#0b2265,295754,56874,58163,120199,0.473165334,0.483889217,-1289,1289,-0.010723883,0.010723883
New York,NY,Erie County,36,29,36029,Bills,#00338d,922578,192065,173817,383248,0.501150691,0.453536613,18248,-18248,0.047614078,-0.047614078
New York,NY,Essex County,36,31,36031,Giants,#0b2265,38478,6760,7275,15079,0.448305591,0.482459049,-515,515,-0.034153458,0.034153458
New York,NY,Franklin County,36,33,36033,Giants,#0b2265,50660,6517,7636,15148,0.430221811,0.50409295,-1119,1119,-0.073871138,0.073871138
New York,NY,Fulton County,36,35,36035,Giants,#0b2265,53992,5805,12759,19563,0.29673363,0.652200583,-6954,6954,-0.355466953,0.355466953
New York,NY,Genesee County,36,37,36037,Bills,#00338d,58937,6946,15986,24463,0.28393901,0.653476679,-9040,9040,-0.369537669,0.369537669
New York,NY,Greene County,36,39,36039,Giants,#0b2265,47625,6370,11546,18869,0.337590757,0.611903122,-5176,5176,-0.274312364,0.274312364
New York,NY,Hamilton County,36,41,36041,Giants,#0b2265,4712,752,1795,2688,0.279761905,0.667782738,-1043,1043,-0.388020833,0.388020833
New York,NY,Herkimer County,36,43,36043,Giants,#0b2265,63100,7289,15664,24261,0.300441037,0.645645274,-8375,8375,-0.345204237,0.345204237
New York,NY,Jefferson County,36,45,36045,Giants,#0b2265,117635,12289,19947,34263,0.358666783,0.58217319,-7658,7658,-0.223506406,0.223506406
New York,NY,Kings County,36,47,36047,Giants,#0b2265,2636735,595086,133653,746295,0.797387092,0.179088698,461433,-461433,0.618298394,-0.618298394
New York,NY,Lewis County,36,49,36049,Giants,#0b2265,26957,2828,6916,10312,0.2742436,0.670674942,-4088,4088,-0.396431342,0.396431342
New York,NY,Livingston County,36,51,36051,Bills,#00338d,64717,10478,19211,31363,0.334087938,0.612537066,-8733,8733,-0.278449128,0.278449128
New York,NY,Madison County,36,53,36053,Giants,#0b2265,71849,10548,14901,27392,0.385075935,0.543990946,-4353,4353,-0.158915012,0.158915012
New York,NY,Monroe County,36,55,36055,Bills,#00338d,749600,174063,128871,320164,0.543668245,0.402515586,45192,-45192,0.141152659,-0.141152659
New York,NY,Montgomery County,36,57,36057,Giants,#0b2265,49642,5961,10579,17438,0.341839661,0.606663608,-4618,4618,-0.264823948,0.264823948
New York,NY,Nassau County,36,59,36059,Giants,#0b2265,1361350,307326,275479,599649,0.512509818,0.459400416,31847,-31847,0.053109402,-0.053109402
New York,NY,New York County,36,61,36061,Giants,#0b2265,1644518,515481,58935,591368,0.871675505,0.099658757,456546,-456546,0.772016748,-0.772016748
New York,NY,Niagara County,36,63,36063,Bills,#00338d,212652,32888,49223,86000,0.382418605,0.572360465,-16335,16335,-0.18994186,0.18994186
New York,NY,Oneida County,36,65,36065,Giants,#0b2265,232500,30749,48490,83876,0.366600696,0.578115313,-17741,17741,-0.211514617,0.211514617
New York,NY,Onondaga County,36,67,36067,Giants,#0b2265,468463,102915,78277,191962,0.536121732,0.407773413,24638,-24638,0.128348319,-0.128348319
New York,NY,Ontario County,36,69,36069,Bills,#00338d,109561,20233,24343,47664,0.424492279,0.510720879,-4110,4110,-0.0862286,0.0862286
New York,NY,Orange County,36,71,36071,Giants,#0b2265,377647,63037,72129,140753,0.447855463,0.512450889,-9092,9092,-0.064595426,0.064595426
New York,NY,Orleans County,36,73,36073,Bills,#00338d,41582,4327,11582,16722,0.258760914,0.6926205,-7255,7255,-0.433859586,0.433859586
New York,NY,Oswego County,36,75,36075,Giants,#0b2265,120146,15614,25870,44122,0.353882417,0.586328816,-10256,10256,-0.232446399,0.232446399
New York,NY,Otsego County,36,77,36077,Giants,#0b2265,60636,9285,12284,23024,0.403274844,0.533530229,-2999,2999,-0.130255386,0.130255386
New York,NY,Putnam County,36,79,36079,Giants,#0b2265,99042,17363,25241,44186,0.392952519,0.571244286,-7878,7878,-0.178291767,0.178291767
New York,NY,Queens County,36,81,36081,Giants,#0b2265,2339150,473389,138550,627021,0.754981093,0.220965486,334839,-334839,0.534015607,-0.534015607
New York,NY,Rensselaer County,36,83,36083,Giants,#0b2265,160266,30039,31933,65991,0.455198436,0.48389932,-1894,1894,-0.028700883,0.028700883
New York,NY,Richmond County,36,85,36085,Giants,#0b2265,474558,67561,95612,167209,0.404051217,0.571811326,-28051,28051,-0.167760109,0.167760109
New York,NY,Rockland County,36,87,36087,Giants,#0b2265,326037,63454,57148,123943,0.511961143,0.461082917,6306,-6306,0.050878226,-0.050878226
New York,NY,St. Lawrence County,36,89,36089,Giants,#0b2265,111007,14659,18450,35154,0.416993799,0.524833589,-3791,3791,-0.107839791,0.107839791
New York,NY,Saratoga County,36,91,36091,Giants,#0b2265,226249,46546,51088,104089,0.447175014,0.490810748,-4542,4542,-0.043635735,0.043635735
New York,NY,Schenectady County,36,93,36093,Giants,#0b2265,154604,30870,27268,61629,0.50090055,0.442454039,3602,-3602,0.058446511,-0.058446511
New York,NY,Schoharie County,36,95,36095,Giants,#0b2265,31330,3777,8173,12673,0.298035193,0.644914385,-4396,4396,-0.346879192,0.346879192
New York,NY,Schuyler County,36,97,36097,Giants,#0b2265,18186,2761,5179,8423,0.327792948,0.614864063,-2418,2418,-0.287071115,0.287071115
New York,NY,Seneca County,36,99,36099,Giants,#0b2265,34833,5175,6719,12727,0.406615856,0.527932741,-1544,1544,-0.121316885,0.121316885
New York,NY,Steuben County,36,101,36101,Bills,#00338d,97631,11215,25091,38373,0.292262789,0.653871212,-13876,13876,-0.361608423,0.361608423
New York,NY,Suffolk County,36,103,36103,Giants,#0b2265,1501587,276953,328403,625720,0.442614908,0.524840184,-51450,51450,-0.082225276,0.082225276
New York,NY,Sullivan County,36,105,36105,Giants,#0b2265,74877,10983,14626,26509,0.41431212,0.551737146,-3643,3643,-0.137425025,0.137425025
New York,NY,Tioga County,36,107,36107,Giants,#0b2265,49453,6852,12528,20556,0.333333333,0.609457093,-5676,5676,-0.276123759,0.276123759
New York,NY,Tompkins County,36,109,36109,Giants,#0b2265,104926,25555,9647,37747,0.677007444,0.255569979,15908,-15908,0.421437465,-0.421437465
New York,NY,Ulster County,36,111,36111,Giants,#0b2265,180143,40010,32962,77134,0.518707703,0.427334249,7048,-7048,0.091373454,-0.091373454
New York,NY,Warren County,36,113,36113,Giants,#0b2265,64688,11366,14284,27568,0.412289611,0.51813697,-2918,2918,-0.105847359,0.105847359
New York,NY,Washington County,36,115,36115,Giants,#0b2265,62230,8238,12770,22401,0.36775144,0.570063836,-4532,4532,-0.202312397,0.202312397
New York,NY,Wayne County,36,117,36117,Bills,#00338d,91446,12378,21935,36598,0.338215203,0.599349691,-9557,9557,-0.261134488,0.261134488
New York,NY,Westchester County,36,119,36119,Giants,#0b2265,976396,245670,121643,378506,0.649051798,0.321376676,124027,-124027,0.327675123,-0.327675123
New York,NY,Wyoming County,36,121,36121,Bills,#00338d,41013,3585,11884,16280,0.220208845,0.72997543,-8299,8299,-0.509766585,0.509766585
New York,NY,Yates County,36,123,36123,Bills,#00338d,25048,3219,5180,8975,0.358662953,0.577158774,-1961,1961,-0.218495822,0.218495822
North Carolina,NC,Alamance County,37,1,37001,Panthers,#0085ca,158276,29268,38235,69264,0.422557173,0.552018365,-8967,8967,-0.129461192,0.129461192
North Carolina,NC,Alexander County,37,3,37003,Panthers,#0085ca,37325,3750,13826,18011,0.208206096,0.767641997,-10076,10076,-0.5594359,0.5594359
North Carolina,NC,Alleghany County,37,5,37005,Panthers,#0085ca,10837,1300,3789,5214,0.24932873,0.726697353,-2489,2489,-0.477368623,0.477368623
North Carolina,NC,Anson County,37,7,37007,Panthers,#0085ca,25759,5785,4480,10394,0.556571099,0.431017895,1305,-1305,0.125553204,-0.125553204
North Carolina,NC,Ashe County,37,9,37009,Panthers,#0085ca,27020,3476,9353,13160,0.264133739,0.710714286,-5877,5877,-0.446580547,0.446580547
North Carolina,NC,Avery County,37,11,37011,Panthers,#0085ca,17689,1670,6226,8060,0.20719603,0.772456576,-4556,4556,-0.565260546,0.565260546
North Carolina,NC,Beaufort County,37,13,37013,Panthers,#0085ca,47651,8699,14478,23599,0.368617314,0.613500572,-5779,5779,-0.244883258,0.244883258
North Carolina,NC,Bertie County,37,15,37015,Cowboys,#002244,20199,5837,3476,9380,0.62228145,0.370575693,2361,-2361,0.251705757,-0.251705757
North Carolina,NC,Bladen County,37,17,37017,Panthers,#0085ca,34318,7021,8511,15743,0.445975989,0.540621228,-1490,1490,-0.094645239,0.094645239
North Carolina,NC,Brunswick County,37,19,37019,Panthers,#0085ca,122765,23117,42440,67255,0.343721656,0.63103115,-19323,19323,-0.287309494,0.287309494
North Carolina,NC,Buncombe County,37,21,37021,Panthers,#0085ca,253178,74937,55339,134507,0.557123421,0.411420967,19598,-19598,0.145702454,-0.145702454
North Carolina,NC,Burke County,37,23,37023,Panthers,#0085ca,88842,10930,25741,37638,0.290398002,0.683909878,-14811,14811,-0.393511876,0.393511876
North Carolina,NC,Cabarrus County,37,25,37025,Panthers,#0085ca,196762,35048,53224,91002,0.385134393,0.584866267,-18176,18176,-0.199731874,0.199731874
North Carolina,NC,Caldwell County,37,27,37027,Panthers,#0085ca,81287,8403,26499,35747,0.235068677,0.741292976,-18096,18096,-0.506224299,0.506224299
North Carolina,NC,Camden County,37,29,37029,Steelers,#ffb612,10309,1266,3527,4939,0.256327192,0.714112168,-2261,2261,-0.457784977,0.457784977
North Carolina,NC,Carteret County,37,31,37031,Panthers,#0085ca,68879,9806,26228,36919,0.265608494,0.710420109,-16422,16422,-0.444811615,0.444811615
North Carolina,NC,Caswell County,37,33,37033,Panthers,#0085ca,22941,4549,5758,10515,0.432620067,0.547598669,-1209,1209,-0.114978602,0.114978602
North Carolina,NC,Catawba County,37,35,37035,Panthers,#0085ca,155056,21050,48062,71065,0.296207697,0.67631042,-27012,27012,-0.380102723,0.380102723
North Carolina,NC,Chatham County,37,37,37037,Panthers,#0085ca,70928,20953,17012,39080,0.536156602,0.43531218,3941,-3941,0.100844422,-0.100844422
North Carolina,NC,Cherokee County,37,39,37039,Falcons,#a71930,27178,2809,10711,13860,0.202669553,0.772799423,-7902,7902,-0.57012987,0.57012987
North Carolina,NC,Chowan County,37,41,37041,Cowboys,#002244,14394,2965,3983,7108,0.417135622,0.56035453,-1018,1018,-0.143218908,0.143218908
North Carolina,NC,Clay County,37,43,37043,Falcons,#a71930,10703,1352,4395,5885,0.229736619,0.746813934,-3043,3043,-0.517077315,0.517077315
North Carolina,NC,Cleveland County,37,45,37045,Panthers,#0085ca,96879,14896,28394,44137,0.337494619,0.643315132,-13498,13498,-0.305820513,0.305820513
North Carolina,NC,Columbus County,37,47,37047,Panthers,#0085ca,56694,8991,14177,23472,0.383052147,0.603996251,-5186,5186,-0.220944104,0.220944104
North Carolina,NC,Craven County,37,49,37049,Panthers,#0085ca,103451,17481,27556,46231,0.378122905,0.596050269,-10075,10075,-0.217927365,0.217927365
North Carolina,NC,Cumberland County,37,51,37051,Panthers,#0085ca,323838,70523,50593,124402,0.566896031,0.406689603,19930,-19930,0.160206428,-0.160206428
North Carolina,NC,Currituck County,37,53,37053,Redskins,#773141,25263,2879,9070,12423,0.231747565,0.7300974,-6191,6191,-0.498349835,0.498349835
North Carolina,NC,Dare County,37,55,37055,Redskins,#773141,35663,7079,11283,19009,0.372402546,0.593560945,-4204,4204,-0.221158399,0.221158399
North Carolina,NC,Davidson County,37,57,37057,Panthers,#0085ca,164622,17328,52870,72013,0.240623221,0.734172997,-35542,35542,-0.493549776,0.493549776
North Carolina,NC,Davie County,37,59,37059,Panthers,#0085ca,41753,5228,15502,21350,0.244871194,0.726088993,-10274,10274,-0.481217799,0.481217799
North Carolina,NC,Duplin County,37,61,37061,Panthers,#0085ca,59159,8196,12151,20601,0.397844765,0.589825737,-3955,3955,-0.191980972,0.191980972
North Carolina,NC,Durham County,37,63,37063,Panthers,#0085ca,300952,118783,27879,150543,0.789030377,0.185189614,90904,-90904,0.603840763,-0.603840763
North Carolina,NC,Edgecombe County,37,65,37065,Panthers,#0085ca,54150,16152,8219,24653,0.655173813,0.333387417,7933,-7933,0.321786395,-0.321786395
North Carolina,NC,Forsyth County,37,67,37067,Panthers,#0085ca,369019,92488,74793,172509,0.536134347,0.433559988,17695,-17695,0.102574358,-0.102574358
North Carolina,NC,Franklin County,37,69,37069,Panthers,#0085ca,63710,12811,16320,29902,0.428432881,0.545782891,-3509,3509,-0.11735001,0.11735001
North Carolina,NC,Gaston County,37,71,37071,Panthers,#0085ca,213442,30982,61467,94872,0.326566321,0.647894005,-30485,30485,-0.321327684,0.321327684
North Carolina,NC,Gates County,37,73,37073,Cowboys,#002244,11431,2371,2851,5328,0.445007508,0.535097598,-480,480,-0.09009009,0.09009009
North Carolina,NC,Graham County,37,75,37075,Panthers,#0085ca,8616,761,3260,4094,0.185881778,0.79628725,-2499,2499,-0.610405471,0.610405471
North Carolina,NC,Granville County,37,77,37077,Panthers,#0085ca,58674,12827,13500,26920,0.476485884,0.501485884,-673,673,-0.025,0.025
North Carolina,NC,Greene County,37,79,37079,Panthers,#0085ca,21134,3570,4358,8013,0.44552602,0.543866217,-788,788,-0.098340197,0.098340197
North Carolina,NC,Guilford County,37,81,37081,Panthers,#0085ca,517600,147949,97461,252087,0.586896587,0.386616525,50488,-50488,0.200280062,-0.200280062
North Carolina,NC,Halifax County,37,83,37083,Panthers,#0085ca,52456,15642,8954,24881,0.628672481,0.359872995,6688,-6688,0.268799486,-0.268799486
North Carolina,NC,Harnett County,37,85,37085,Panthers,#0085ca,128140,16452,27278,44955,0.365965966,0.606784562,-10826,10826,-0.240818596,0.240818596
North Carolina,NC,Haywood County,37,87,37087,Panthers,#0085ca,59868,10414,18844,30156,0.345337578,0.624883937,-8430,8430,-0.279546359,0.279546359
North Carolina,NC,Henderson County,37,89,37089,Panthers,#0085ca,112655,19664,35535,56810,0.346136244,0.625506073,-15871,15871,-0.279369829,0.279369829
North Carolina,NC,Hertford County,37,91,37091,Cowboys,#002244,24184,6886,3081,10100,0.681782178,0.305049505,3805,-3805,0.376732673,-0.376732673
North Carolina,NC,Hoke County,37,93,37093,Panthers,#0085ca,52671,9608,7676,17847,0.538353785,0.430100297,1932,-1932,0.108253488,-0.108253488
North Carolina,NC,Hyde County,37,95,37095,Panthers,#0085ca,5526,956,1275,2273,0.420589529,0.560932688,-319,319,-0.140343159,0.140343159
North Carolina,NC,Iredell County,37,97,37097,Panthers,#0085ca,169866,24441,54164,80727,0.302761158,0.670952717,-29723,29723,-0.368191559,0.368191559
North Carolina,NC,Jackson County,37,99,37099,Panthers,#0085ca,41265,7564,9706,18004,0.42012886,0.539102422,-2142,2142,-0.118973561,0.118973561
North Carolina,NC,Johnston County,37,101,37101,Panthers,#0085ca,185660,28153,54082,84553,0.332962757,0.639622485,-25929,25929,-0.306659728,0.306659728
North Carolina,NC,Jones County,37,103,37103,Panthers,#0085ca,10013,2041,2941,5039,0.405040683,0.583647549,-900,900,-0.178606866,0.178606866
North Carolina,NC,Lee County,37,105,37105,Panthers,#0085ca,59660,10380,13625,24676,0.420651645,0.552155941,-3245,3245,-0.131504296,0.131504296
North Carolina,NC,Lenoir County,37,107,37107,Panthers,#0085ca,58106,11752,13354,25500,0.460862745,0.523686275,-1602,1602,-0.062823529,0.062823529
North Carolina,NC,Lincoln County,37,109,37109,Panthers,#0085ca,81035,9836,28653,39449,0.249334584,0.726330198,-18817,18817,-0.476995615,0.476995615
North Carolina,NC,McDowell County,37,111,37111,Panthers,#0085ca,44989,4645,14517,19557,0.237510866,0.742291763,-9872,9872,-0.504780897,0.504780897
North Carolina,NC,Macon County,37,113,37113,Panthers,#0085ca,34201,4841,12035,17336,0.279245501,0.69422012,-7194,7194,-0.414974619,0.414974619
North Carolina,NC,Madison County,37,115,37115,Panthers,#0085ca,21139,3899,6735,10966,0.355553529,0.614171074,-2836,2836,-0.258617545,0.258617545
North Carolina,NC,Martin County,37,117,37117,Panthers,#0085ca,23357,5814,5874,11852,0.490550118,0.495612555,-60,60,-0.005062437,0.005062437
North Carolina,NC,Mecklenburg County,37,119,37119,Panthers,#0085ca,1034070,292258,154303,461834,0.632820451,0.334109225,137955,-137955,0.298711225,-0.298711225
North Carolina,NC,Mitchell County,37,121,37121,Panthers,#0085ca,15246,1585,6225,7948,0.199421238,0.783215903,-4640,4640,-0.583794665,0.583794665
North Carolina,NC,Montgomery County,37,123,37123,Panthers,#0085ca,27548,4108,7070,11449,0.35880863,0.617521181,-2962,2962,-0.258712551,0.258712551
North Carolina,NC,Moore County,37,125,37125,Panthers,#0085ca,94352,16148,30273,47746,0.338206342,0.634042642,-14125,14125,-0.2958363,0.2958363
North Carolina,NC,Nash County,37,127,37127,Panthers,#0085ca,93919,23024,23142,46903,0.490885444,0.493401275,-118,118,-0.002515831,0.002515831
North Carolina,NC,New Hanover County,37,129,37129,Panthers,#0085ca,220358,50219,54665,108737,0.461839116,0.502726763,-4446,4446,-0.040887646,0.040887646
North Carolina,NC,Northampton County,37,131,37131,Cowboys,#002244,20426,6113,3556,9761,0.6262678,0.364306936,2557,-2557,0.261960865,-0.261960865
North Carolina,NC,Onslow County,37,133,37133,Panthers,#0085ca,186311,17156,36342,55364,0.309876454,0.656419334,-19186,19186,-0.34654288,0.34654288
North Carolina,NC,Orange County,37,135,37135,Panthers,#0085ca,141354,59105,18373,79830,0.74038582,0.230151572,40732,-40732,0.510234248,-0.510234248
North Carolina,NC,Pamlico County,37,137,37137,Panthers,#0085ca,12781,2427,4225,6772,0.358387478,0.623892499,-1798,1798,-0.265505021,0.265505021
North Carolina,NC,Pasquotank County,37,139,37139,Cowboys,#002244,39829,8455,8082,16964,0.498408394,0.476420656,373,-373,0.021987739,-0.021987739
North Carolina,NC,Pender County,37,141,37141,Panthers,#0085ca,57611,9086,17317,27072,0.335623522,0.639664598,-8231,8231,-0.304041076,0.304041076
North Carolina,NC,Perquimans County,37,143,37143,Cowboys,#002244,13440,2291,4143,6595,0.347384382,0.628203184,-1852,1852,-0.280818802,0.280818802
North Carolina,NC,Person County,37,145,37145,Panthers,#0085ca,39259,7772,11116,19303,0.402631715,0.575869036,-3344,3344,-0.173237321,0.173237321
North Carolina,NC,Pitt County,37,147,37147,Panthers,#0085ca,175842,40967,35191,78264,0.523446284,0.449644792,5776,-5776,0.073801492,-0.073801492
North Carolina,NC,Polk County,37,149,37149,Panthers,#0085ca,20366,3715,6738,10723,0.346451553,0.628368927,-3023,3023,-0.281917374,0.281917374
North Carolina,NC,Randolph County,37,151,37151,Panthers,#0085ca,142799,13074,49156,63615,0.205517567,0.772710839,-36082,36082,-0.567193272,0.567193272
North Carolina,NC,Richmond County,37,153,37153,Panthers,#0085ca,45437,8290,10199,18813,0.44065274,0.542125126,-1909,1909,-0.101472386,0.101472386
North Carolina,NC,Robeson County,37,155,37155,Panthers,#0085ca,134197,18377,20294,39454,0.465782937,0.514371166,-1917,1917,-0.048588229,0.048588229
North Carolina,NC,Rockingham County,37,157,37157,Panthers,#0085ca,91758,14057,26463,41374,0.339754435,0.639604583,-12406,12406,-0.299850147,0.299850147
North Carolina,NC,Rowan County,37,159,37159,Panthers,#0085ca,139142,19208,42388,63078,0.304511874,0.671993405,-23180,23180,-0.367481531,0.367481531
North Carolina,NC,Rutherford County,37,161,37161,Panthers,#0085ca,66390,7451,21694,29764,0.250335976,0.728867088,-14243,14243,-0.478531111,0.478531111
North Carolina,NC,Sampson County,37,163,37163,Panthers,#0085ca,63724,10486,14761,25638,0.409002262,0.575746938,-4275,4275,-0.166744676,0.166744676
North Carolina,NC,Scotland County,37,165,37165,Panthers,#0085ca,35509,7279,6212,13743,0.529651459,0.452011933,1067,-1067,0.077639526,-0.077639526
North Carolina,NC,Stanly County,37,167,37167,Panthers,#0085ca,60714,7008,21788,29451,0.237954569,0.7398051,-14780,14780,-0.501850531,0.501850531
North Carolina,NC,Stokes County,37,169,37169,Panthers,#0085ca,46351,4645,16976,22182,0.209404021,0.765305202,-12331,12331,-0.555901181,0.555901181
North Carolina,NC,Surry County,37,171,37171,Panthers,#0085ca,72743,7438,23495,31663,0.234911411,0.742033288,-16057,16057,-0.507121877,0.507121877
North Carolina,NC,Swain County,37,173,37173,Panthers,#0085ca,14434,2186,3557,5982,0.365429622,0.594617185,-1371,1371,-0.229187563,0.229187563
North Carolina,NC,Transylvania County,37,175,37175,Panthers,#0085ca,33211,6520,10441,17440,0.373853211,0.598681193,-3921,3921,-0.224827982,0.224827982
North Carolina,NC,Tyrrell County,37,177,37177,Panthers,#0085ca,4070,705,968,1700,0.414705882,0.569411765,-263,263,-0.154705882,0.154705882
North Carolina,NC,Union County,37,179,37179,Panthers,#0085ca,222742,34051,66265,103596,0.328690297,0.639648249,-32214,32214,-0.310957952,0.310957952
North Carolina,NC,Vance County,37,181,37181,Panthers,#0085ca,44568,12168,7304,19762,0.615727153,0.369598219,4864,-4864,0.246128934,-0.246128934
North Carolina,NC,Wake County,37,183,37183,Panthers,#0085ca,1024198,298353,193607,510940,0.58392962,0.378923161,104746,-104746,0.205006459,-0.205006459
North Carolina,NC,Warren County,37,185,37185,Panthers,#0085ca,20155,6668,3302,10123,0.658698014,0.326187889,3366,-3366,0.332510125,-0.332510125
North Carolina,NC,Washington County,37,187,37187,Panthers,#0085ca,12385,3490,2560,6115,0.570727719,0.418642682,930,-930,0.152085037,-0.152085037
North Carolina,NC,Watauga County,37,189,37189,Panthers,#0085ca,52906,13953,13521,28769,0.485001217,0.469985053,432,-432,0.015016163,-0.015016163
North Carolina,NC,Wayne County,37,191,37191,Panthers,#0085ca,124132,21520,27360,49824,0.43192036,0.549132948,-5840,5840,-0.117212588,0.117212588
North Carolina,NC,Wilkes County,37,193,37193,Panthers,#0085ca,68502,6596,23613,30844,0.213850344,0.765562184,-17017,17017,-0.55171184,0.55171184
North Carolina,NC,Wilson County,37,195,37195,Panthers,#0085ca,81714,19527,17410,37593,0.519431809,0.463118134,2117,-2117,0.056313675,-0.056313675
North Carolina,NC,Yadkin County,37,197,37197,Panthers,#0085ca,37585,3140,13815,17350,0.180979827,0.796253602,-10675,10675,-0.615273775,0.615273775
North Carolina,NC,Yancey County,37,199,37199,Panthers,#0085ca,17587,3181,6367,9808,0.32432708,0.649163948,-3186,3186,-0.324836868,0.324836868
North Dakota,ND,Adams County,38,1,38001,Vikings,#4f2683,2359,216,904,1206,0.179104478,0.749585406,-688,688,-0.570480929,0.570480929
North Dakota,ND,Barnes County,38,3,38003,Vikings,#4f2683,11099,1597,3156,5253,0.304016752,0.600799543,-1559,1559,-0.296782791,0.296782791
North Dakota,ND,Benson County,38,5,38005,Vikings,#4f2683,6753,842,927,1940,0.434020619,0.477835052,-85,85,-0.043814433,0.043814433
North Dakota,ND,Billings County,38,7,38007,Vikings,#4f2683,936,58,492,592,0.097972973,0.831081081,-434,434,-0.733108108,0.733108108
North Dakota,ND,Bottineau County,38,9,38009,Vikings,#4f2683,6716,734,2482,3437,0.213558336,0.722141402,-1748,1748,-0.508583067,0.508583067
North Dakota,ND,Bowman County,38,11,38011,Vikings,#4f2683,3294,227,1445,1769,0.128321085,0.816845676,-1218,1218,-0.68852459,0.68852459
North Dakota,ND,Burke County,38,13,38013,Vikings,#4f2683,2308,118,879,1031,0.114451988,0.85257032,-761,761,-0.738118332,0.738118332
North Dakota,ND,Burleigh County,38,15,38015,Vikings,#4f2683,92991,10865,32499,46874,0.231791612,0.693326791,-21634,21634,-0.461535179,0.461535179
North Dakota,ND,Cass County,38,17,38017,Vikings,#4f2683,171512,31291,39738,78807,0.397058637,0.504244547,-8447,8447,-0.10718591,0.10718591
North Dakota,ND,Cavalier County,38,19,38019,Vikings,#4f2683,3828,476,1356,1969,0.24174708,0.688674454,-880,880,-0.446927374,0.446927374
North Dakota,ND,Dickey County,38,21,38021,Vikings,#4f2683,5104,551,1656,2372,0.232293423,0.698145025,-1105,1105,-0.465851602,0.465851602
North Dakota,ND,Divide County,38,23,38023,Vikings,#4f2683,2450,243,860,1187,0.204717776,0.724515586,-617,617,-0.51979781,0.51979781
North Dakota,ND,Dunn County,38,25,38025,Packers,#203731,4646,356,1753,2199,0.161891769,0.797180537,-1397,1397,-0.635288768,0.635288768
North Dakota,ND,Eddy County,38,27,38027,Vikings,#4f2683,2365,354,790,1219,0.290401969,0.64807219,-436,436,-0.357670221,0.357670221
North Dakota,ND,Emmons County,38,29,38029,Vikings,#4f2683,3402,215,1672,1959,0.109749872,0.853496682,-1457,1457,-0.74374681,0.74374681
North Dakota,ND,Foster County,38,31,38031,Vikings,#4f2683,3356,346,1237,1699,0.203649205,0.728075338,-891,891,-0.524426133,0.524426133
North Dakota,ND,Golden Valley County,38,33,38033,Vikings,#4f2683,1845,99,793,942,0.105095541,0.841825902,-694,694,-0.736730361,0.736730361
North Dakota,ND,Grand Forks County,38,35,38035,Vikings,#4f2683,70916,10828,16325,29711,0.364444145,0.549459796,-5497,5497,-0.185015651,0.185015651
North Dakota,ND,Grant County,38,37,38037,Vikings,#4f2683,2388,187,1098,1361,0.137398971,0.806759735,-911,911,-0.669360764,0.669360764
North Dakota,ND,Griggs County,38,39,38039,Vikings,#4f2683,2314,298,847,1247,0.238973536,0.679230152,-549,549,-0.440256616,0.440256616
North Dakota,ND,Hettinger County,38,41,38041,Vikings,#4f2683,2704,168,1032,1261,0.133227597,0.818398097,-864,864,-0.6851705,0.6851705
North Dakota,ND,Kidder County,38,43,38043,Vikings,#4f2683,2417,179,1106,1358,0.131811487,0.81443299,-927,927,-0.682621502,0.682621502
North Dakota,ND,LaMoure County,38,45,38045,Vikings,#4f2683,4125,500,1475,2115,0.236406619,0.697399527,-975,975,-0.460992908,0.460992908
North Dakota,ND,Logan County,38,47,38047,Vikings,#4f2683,1935,112,867,1030,0.108737864,0.841747573,-755,755,-0.733009709,0.733009709
North Dakota,ND,McHenry County,38,49,38049,Vikings,#4f2683,5968,474,1991,2687,0.176404913,0.740975065,-1517,1517,-0.564570153,0.564570153
North Dakota,ND,McIntosh County,38,51,38051,Vikings,#4f2683,2759,233,1095,1423,0.16373858,0.769501054,-862,862,-0.605762474,0.605762474
North Dakota,ND,McKenzie County,38,53,38053,Vikings,#4f2683,12826,696,3661,4594,0.151501959,0.796909012,-2965,2965,-0.645407053,0.645407053
North Dakota,ND,McLean County,38,55,38055,Vikings,#4f2683,9744,1070,3827,5206,0.205532078,0.735113331,-2757,2757,-0.529581252,0.529581252
North Dakota,ND,Mercer County,38,57,38057,Vikings,#4f2683,8853,616,3715,4564,0.134969325,0.813978966,-3099,3099,-0.679009641,0.679009641
North Dakota,ND,Morton County,38,59,38059,Vikings,#4f2683,30310,3077,11319,15547,0.197915997,0.728050428,-8242,8242,-0.530134431,0.530134431
North Dakota,ND,Mountrail County,38,61,38061,Vikings,#4f2683,10331,1211,2551,4009,0.302070342,0.636318284,-1340,1340,-0.334247942,0.334247942
North Dakota,ND,Nelson County,38,63,38063,Vikings,#4f2683,2968,536,1025,1694,0.316410862,0.605076741,-489,489,-0.28866588,0.28866588
North Dakota,ND,Oliver County,38,65,38065,Vikings,#4f2683,1846,119,827,1002,0.118762475,0.825349301,-708,708,-0.706586826,0.706586826
North Dakota,ND,Pembina County,38,67,38067,Vikings,#4f2683,7091,681,2204,3093,0.220174588,0.712576786,-1523,1523,-0.492402199,0.492402199
North Dakota,ND,Pierce County,38,69,38069,Vikings,#4f2683,4312,431,1433,2020,0.213366337,0.709405941,-1002,1002,-0.496039604,0.496039604
North Dakota,ND,Ramsey County,38,71,38071,Vikings,#4f2683,11630,1505,3216,5218,0.288424684,0.616328095,-1711,1711,-0.327903411,0.327903411
North Dakota,ND,Ransom County,38,73,38073,Vikings,#4f2683,5448,836,1209,2317,0.360811394,0.521795425,-373,373,-0.160984031,0.160984031
North Dakota,ND,Renville County,38,75,38075,Vikings,#4f2683,2571,200,978,1255,0.15936255,0.779282869,-778,778,-0.619920319,0.619920319
North Dakota,ND,Richland County,38,77,38077,Vikings,#4f2683,16402,2064,4759,7460,0.276675603,0.637935657,-2695,2695,-0.361260054,0.361260054
North Dakota,ND,Rolette County,38,79,38079,Vikings,#4f2683,14649,2097,1210,3662,0.572637903,0.330420535,887,-887,0.242217368,-0.242217368
North Dakota,ND,Sargent County,38,81,38081,Vikings,#4f2683,3876,693,1088,1978,0.350353893,0.550050556,-395,395,-0.199696663,0.199696663
North Dakota,ND,Sheridan County,38,83,38083,Vikings,#4f2683,1310,94,644,774,0.121447028,0.832041344,-550,550,-0.710594315,0.710594315
North Dakota,ND,Sioux County,38,85,38085,Vikings,#4f2683,4370,758,256,1177,0.644010195,0.217502124,502,-502,0.426508071,-0.426508071
North Dakota,ND,Slope County,38,87,38087,Packers,#203731,767,42,361,427,0.098360656,0.845433255,-319,319,-0.7470726,0.7470726
North Dakota,ND,Stark County,38,89,38089,Vikings,#4f2683,32154,1745,9718,12115,0.144036319,0.8021461,-7973,7973,-0.658109781,0.658109781
North Dakota,ND,Steele County,38,91,38091,Vikings,#4f2683,1956,361,537,984,0.366869919,0.545731707,-176,176,-0.178861789,0.178861789
North Dakota,ND,Stutsman County,38,93,38093,Vikings,#4f2683,21103,2484,6706,9938,0.249949688,0.674783659,-4222,4222,-0.424833971,0.424833971
North Dakota,ND,Towner County,38,95,38095,Vikings,#4f2683,2272,305,733,1137,0.26824978,0.64467898,-428,428,-0.3764292,0.3764292
North Dakota,ND,Traill County,38,97,38097,Vikings,#4f2683,8014,1239,2263,3864,0.320652174,0.585662526,-1024,1024,-0.265010352,0.265010352
North Dakota,ND,Walsh County,38,99,38099,Vikings,#4f2683,10897,1166,2991,4543,0.256658596,0.658375523,-1825,1825,-0.401716927,0.401716927
North Dakota,ND,Ward County,38,101,38101,Vikings,#4f2683,71275,5792,18601,26861,0.215628607,0.692490972,-12809,12809,-0.476862366,0.476862366
North Dakota,ND,Wells County,38,103,38103,Vikings,#4f2683,4168,419,1793,2352,0.178146259,0.762329932,-1374,1374,-0.584183673,0.584183673
North Dakota,ND,Williams County,38,105,38105,Vikings,#4f2683,35294,1722,10033,12529,0.137441137,0.800782185,-8311,8311,-0.663341049,0.663341049
Ohio,OH,Adams County,39,1,39001,Bengals,#fb4f14,28024,2293,8445,11063,0.207267468,0.763355329,-6152,6152,-0.55608786,0.55608786
Ohio,OH,Allen County,39,3,39003,Browns,#22150c,104425,12815,29858,44636,0.287100099,0.668921946,-17043,17043,-0.381821848,0.381821848
Ohio,OH,Ashland County,39,5,39005,Browns,#22150c,53213,5659,17169,24074,0.235066877,0.713176041,-11510,11510,-0.478109163,0.478109163
Ohio,OH,Ashtabula County,39,7,39007,Browns,#22150c,98632,15191,22755,39809,0.381597126,0.571604411,-7564,7564,-0.190007285,0.190007285
Ohio,OH,Athens County,39,9,39009,Browns,#22150c,65886,15552,10816,27941,0.55660141,0.387101392,4736,-4736,0.169500018,-0.169500018
Ohio,OH,Auglaize County,39,11,39011,Browns,#22150c,45876,3825,18130,22860,0.167322835,0.793088364,-14305,14305,-0.625765529,0.625765529
Ohio,OH,Belmont County,39,13,39013,Steelers,#ffb612,69154,8652,20729,30537,0.283328421,0.678815863,-12077,12077,-0.395487441,0.395487441
Ohio,OH,Brown County,39,15,39015,Bengals,#fb4f14,43839,4270,14257,19139,0.223104655,0.744918752,-9987,9987,-0.521814097,0.521814097
Ohio,OH,Butler County,39,17,39017,Bengals,#fb4f14,376353,56700,104441,168422,0.336654356,0.620114949,-47741,47741,-0.283460593,0.283460593
Ohio,OH,Carroll County,39,19,39019,Steelers,#ffb612,27811,3124,9067,12807,0.243929101,0.707972203,-5943,5943,-0.464043101,0.464043101
Ohio,OH,Champaign County,39,21,39021,Bengals,#fb4f14,38987,4488,12314,17597,0.255043473,0.699778371,-7826,7826,-0.444734898,0.444734898
Ohio,OH,Clark County,39,23,39023,Bengals,#fb4f14,135959,22666,34311,59620,0.380174438,0.5754948,-11645,11645,-0.195320362,0.195320362
Ohio,OH,Clermont County,39,25,39025,Bengals,#fb4f14,201973,26096,65960,96455,0.270551034,0.683842206,-39864,39864,-0.413291172,0.413291172
Ohio,OH,Clinton County,39,27,39027,Bengals,#fb4f14,41917,3943,13466,18100,0.217845304,0.743977901,-9523,9523,-0.526132597,0.526132597
Ohio,OH,Columbiana County,39,29,39029,Steelers,#ffb612,104806,12273,31086,45261,0.271160602,0.686816465,-18813,18813,-0.415655863,0.415655863
Ohio,OH,Coshocton County,39,31,39031,Browns,#22150c,36569,3908,10381,14961,0.261212486,0.693870731,-6473,6473,-0.432658245,0.432658245
Ohio,OH,Crawford County,39,33,39033,Browns,#22150c,42306,4518,13265,18702,0.241578441,0.70928243,-8747,8747,-0.467703989,0.467703989
Ohio,OH,Cuyahoga County,39,35,39035,Browns,#22150c,1255921,383974,179894,583230,0.658357766,0.308444353,204080,-204080,0.349913413,-0.349913413
Ohio,OH,Darke County,39,37,39037,Bengals,#fb4f14,52076,4395,19698,25000,0.1758,0.78792,-15303,15303,-0.61212,0.61212
Ohio,OH,Defiance County,39,39,39039,Steelers,#ffb612,38352,5282,11478,17795,0.296824951,0.645012644,-6196,6196,-0.348187693,0.348187693
Ohio,OH,Delaware County,39,41,39041,Browns,#22150c,193013,39584,55660,100101,0.395440605,0.556038401,-16076,16076,-0.160597796,0.160597796
Ohio,OH,Erie County,39,43,39043,Browns,#22150c,75550,15692,19301,36730,0.427225701,0.525483256,-3609,3609,-0.098257555,0.098257555
Ohio,OH,Fairfield County,39,45,39045,Browns,#22150c,151408,24150,43163,70542,0.342349239,0.611876613,-19013,19013,-0.269527374,0.269527374
Ohio,OH,Fayette County,39,47,39047,Bengals,#fb4f14,28679,2672,7763,10817,0.247018582,0.717666636,-5091,5091,-0.470648054,0.470648054
Ohio,OH,Franklin County,39,49,39049,Browns,#22150c,1251722,335961,192328,554711,0.60565051,0.34671748,143633,-143633,0.25893303,-0.25893303
Ohio,OH,Fulton County,39,51,39051,Steelers,#ffb612,42537,5981,13419,20693,0.289034939,0.648480162,-7438,7438,-0.359445223,0.359445223
Ohio,OH,Gallia County,39,53,39053,Bengals,#fb4f14,30142,2564,9567,12588,0.20368605,0.760009533,-7003,7003,-0.556323483,0.556323483
Ohio,OH,Geauga County,39,55,39055,Browns,#22150c,94102,17165,29577,48736,0.35220371,0.606881976,-12412,12412,-0.254678267,0.254678267
Ohio,OH,Greene County,39,57,39057,Bengals,#fb4f14,164427,28023,47506,79633,0.35190185,0.596561727,-19483,19483,-0.244659877,0.244659877
Ohio,OH,Guernsey County,39,59,39059,Steelers,#ffb612,39258,4286,11164,16156,0.265288438,0.691012627,-6878,6878,-0.425724189,0.425724189
Ohio,OH,Hamilton County,39,61,39061,Bengals,#fb4f14,807598,207587,169972,395000,0.525536709,0.430308861,37615,-37615,0.095227848,-0.095227848
Ohio,OH,Hancock County,39,63,39063,Browns,#22150c,75573,9419,23777,35216,0.267463653,0.675176056,-14358,14358,-0.407712403,0.407712403
Ohio,OH,Hardin County,39,65,39065,Browns,#22150c,31682,2870,8541,12014,0.238887964,0.710920593,-5671,5671,-0.472032629,0.472032629
Ohio,OH,Harrison County,39,67,39067,Steelers,#ffb612,15450,1663,5021,6956,0.239074181,0.721822887,-3358,3358,-0.482748706,0.482748706
Ohio,OH,Henry County,39,69,39069,Browns,#22150c,27816,3690,9136,13671,0.269914417,0.668275913,-5446,5446,-0.398361495,0.398361495
Ohio,OH,Highland County,39,71,39071,Bengals,#fb4f14,43026,3436,13005,17048,0.201548569,0.762846082,-9569,9569,-0.561297513,0.561297513
Ohio,OH,Hocking County,39,73,39073,Bengals,#fb4f14,28491,3713,8282,12513,0.296731399,0.661871653,-4569,4569,-0.365140254,0.365140254
Ohio,OH,Holmes County,39,75,39075,Browns,#22150c,43909,1766,8578,10823,0.163171025,0.792571376,-6812,6812,-0.629400351,0.629400351
Ohio,OH,Huron County,39,77,39077,Browns,#22150c,58469,7080,15930,24332,0.290974848,0.654693408,-8850,8850,-0.36371856,0.36371856
Ohio,OH,Jackson County,39,79,39079,Bengals,#fb4f14,32596,3142,9618,13239,0.237329103,0.726489916,-6476,6476,-0.489160813,0.489160813
Ohio,OH,Jefferson County,39,81,39081,Steelers,#ffb612,67347,9483,20668,31346,0.302526638,0.659350475,-11185,11185,-0.356823837,0.356823837
Ohio,OH,Knox County,39,83,39083,Browns,#22150c,61061,7959,18563,27768,0.286624892,0.668503313,-10604,10604,-0.381878421,0.381878421
Ohio,OH,Lake County,39,85,39085,Browns,#22150c,229245,45056,62627,112790,0.399468038,0.555253125,-17571,17571,-0.155785087,0.155785087
Ohio,OH,Lawrence County,39,87,39087,Bengals,#fb4f14,61109,6849,18240,25949,0.263940807,0.702917261,-11391,11391,-0.438976454,0.438976454
Ohio,OH,Licking County,39,89,39089,Browns,#22150c,170570,26360,49346,79399,0.331994106,0.621493973,-22986,22986,-0.289499868,0.289499868
Ohio,OH,Logan County,39,91,39091,Bengals,#fb4f14,45386,4537,15586,21007,0.215975627,0.741943162,-11049,11049,-0.525967535,0.525967535
Ohio,OH,Lorain County,39,93,39093,Browns,#22150c,305147,64958,65346,136654,0.475346496,0.478185783,-388,388,-0.002839288,0.002839288
Ohio,OH,Lucas County,39,95,39095,Steelers,#ffb612,433689,107363,74102,191684,0.56010413,0.38658417,33261,-33261,0.17351996,-0.17351996
Ohio,OH,Madison County,39,97,39097,Browns,#22150c,44094,4662,11319,16754,0.278261908,0.675599857,-6657,6657,-0.397337949,0.397337949
Ohio,OH,Mahoning County,39,99,39099,Steelers,#ffb612,231900,56188,52808,112827,0.498001365,0.468043997,3380,-3380,0.029957368,-0.029957368
Ohio,OH,Marion County,39,101,39101,Browns,#22150c,65355,7748,16563,25648,0.302089832,0.645781347,-8815,8815,-0.343691516,0.343691516
Ohio,OH,Medina County,39,103,39103,Browns,#22150c,176395,31582,53811,89360,0.353424351,0.602182184,-22229,22229,-0.248757833,0.248757833
Ohio,OH,Meigs County,39,105,39105,Steelers,#ffb612,23257,2157,6869,9410,0.22922423,0.729968119,-4712,4712,-0.500743889,0.500743889
Ohio,OH,Mercer County,39,107,39107,Bengals,#fb4f14,40968,3335,17200,21315,0.156462585,0.806943467,-13865,13865,-0.650480882,0.650480882
Ohio,OH,Miami County,39,109,39109,Bengals,#fb4f14,104224,12832,36311,51467,0.24932481,0.705520042,-23479,23479,-0.456195232,0.456195232
Ohio,OH,Monroe County,39,111,39111,Steelers,#ffb612,14409,1647,4781,6686,0.246335627,0.715076279,-3134,3134,-0.468740652,0.468740652
Ohio,OH,Montgomery County,39,113,39113,Bengals,#fb4f14,532258,117661,120766,249560,0.471473794,0.483915692,-3105,3105,-0.012441898,0.012441898
Ohio,OH,Morgan County,39,115,39115,Steelers,#ffb612,14777,1711,4315,6290,0.272019078,0.686009539,-2604,2604,-0.413990461,0.413990461
Ohio,OH,Morrow County,39,117,39117,Browns,#22150c,35074,3711,11722,16186,0.229272211,0.724206104,-8011,8011,-0.494933893,0.494933893
Ohio,OH,Muskingum County,39,119,39119,Steelers,#ffb612,86290,10926,23588,36217,0.301681531,0.651296353,-12662,12662,-0.349614822,0.349614822
Ohio,OH,Noble County,39,121,39121,Steelers,#ffb612,14326,1201,4441,5875,0.204425532,0.755914894,-3240,3240,-0.551489362,0.551489362
Ohio,OH,Ottawa County,39,123,39123,Browns,#22150c,40877,8136,12389,21742,0.374206605,0.569818784,-4253,4253,-0.195612179,0.195612179
Ohio,OH,Paulding County,39,125,39125,Colts,#002c5f,18976,2068,6359,8842,0.233883737,0.719181181,-4291,4291,-0.485297444,0.485297444
Ohio,OH,Perry County,39,127,39127,Browns,#22150c,35985,4072,9978,14647,0.278009149,0.681231652,-5906,5906,-0.403222503,0.403222503
Ohio,OH,Pickaway County,39,129,39129,Bengals,#fb4f14,56998,6325,16482,23814,0.265600067,0.692113883,-10157,10157,-0.426513815,0.426513815
Ohio,OH,Pike County,39,131,39131,Bengals,#fb4f14,28217,3443,7669,11513,0.299053244,0.666116564,-4226,4226,-0.36706332,0.36706332
Ohio,OH,Portage County,39,133,39133,Browns,#22150c,162275,31463,38978,73968,0.425359615,0.526957603,-7515,7515,-0.101597988,0.101597988
Ohio,OH,Preble County,39,135,39135,Bengals,#fb4f14,41329,4323,15376,20475,0.211135531,0.750964591,-11053,11053,-0.53982906,0.53982906
Ohio,OH,Putnam County,39,137,39137,Browns,#22150c,34042,2874,14704,18387,0.156306086,0.799695437,-11830,11830,-0.643389351,0.643389351
Ohio,OH,Richland County,39,139,39139,Browns,#22150c,121707,15629,35805,53739,0.290831612,0.666275889,-20176,20176,-0.375444277,0.375444277
Ohio,OH,Ross County,39,141,39141,Bengals,#fb4f14,77170,9905,17833,28955,0.342082542,0.615886721,-7928,7928,-0.273804179,0.273804179
Ohio,OH,Sandusky County,39,143,39143,Browns,#22150c,59679,9733,16045,27491,0.354043141,0.583645557,-6312,6312,-0.229602415,0.229602415
Ohio,OH,Scioto County,39,145,39145,Bengals,#fb4f14,76825,8841,19742,29618,0.298500912,0.666554122,-10901,10901,-0.368053211,0.368053211
Ohio,OH,Seneca County,39,147,39147,Browns,#22150c,55610,7237,14559,23481,0.308206635,0.620033218,-7322,7322,-0.311826583,0.311826583
Ohio,OH,Shelby County,39,149,39149,Bengals,#fb4f14,48901,4143,18148,23110,0.179273042,0.785287754,-14005,14005,-0.606014712,0.606014712
Ohio,OH,Stark County,39,151,39151,Browns,#22150c,375165,66581,96345,170868,0.389663366,0.56385631,-29764,29764,-0.174192944,0.174192944
Ohio,OH,Summit County,39,153,39153,Browns,#22150c,541968,129922,109531,249937,0.519818994,0.438234435,20391,-20391,0.081584559,-0.081584559
Ohio,OH,Trumbull County,39,155,39155,Steelers,#ffb612,203751,42130,48152,94073,0.447843696,0.511857813,-6022,6022,-0.064014117,0.064014117
Ohio,OH,Tuscarawas County,39,157,39157,Browns,#22150c,92916,11895,26105,40088,0.296722211,0.651192377,-14210,14210,-0.354470166,0.354470166
Ohio,OH,Union County,39,159,39159,Browns,#22150c,54277,7530,17601,26533,0.283797535,0.663362605,-10071,10071,-0.37956507,0.37956507
Ohio,OH,Van Wert County,39,161,39161,Browns,#22150c,28562,2667,10328,13584,0.196333922,0.760306243,-7661,7661,-0.56397232,0.56397232
Ohio,OH,Vinton County,39,163,39163,Bengals,#fb4f14,13048,1332,3799,5393,0.246986835,0.704431671,-2467,2467,-0.457444836,0.457444836
Ohio,OH,Warren County,39,165,39165,Bengals,#fb4f14,224469,33036,75947,114254,0.289145238,0.66472071,-42911,42911,-0.375575472,0.375575472
Ohio,OH,Washington County,39,167,39167,Steelers,#ffb612,61112,7841,19901,28992,0.270453918,0.68643074,-12060,12060,-0.415976821,0.415976821
Ohio,OH,Wayne County,39,169,39169,Browns,#22150c,116063,14670,31622,48550,0.302162719,0.651328527,-16952,16952,-0.349165808,0.349165808
Ohio,OH,Williams County,39,171,39171,Steelers,#ffb612,37120,4287,11706,16938,0.253099539,0.69110875,-7419,7419,-0.43800921,0.43800921
Ohio,OH,Wood County,39,173,39173,Browns,#22150c,129730,26440,31734,62287,0.424486651,0.509480309,-5294,5294,-0.084993658,0.084993658
Ohio,OH,Wyandot County,39,175,39175,Browns,#22150c,22243,2484,7346,10396,0.238938053,0.70661793,-4862,4862,-0.467679877,0.467679877
Oklahoma,OK,Adair County,40,1,40001,Cowboys,#002244,22004,1374,4753,6468,0.212430427,0.734848485,-3379,3379,-0.522418058,0.522418058
Oklahoma,OK,Alfalfa County,40,3,40003,Cowboys,#002244,5868,216,1931,2256,0.095744681,0.855939716,-1715,1715,-0.760195035,0.760195035
Oklahoma,OK,Atoka County,40,5,40005,Cowboys,#002244,13793,795,4068,5002,0.158936425,0.81327469,-3273,3273,-0.654338265,0.654338265
Oklahoma,OK,Beaver County,40,7,40007,Cowboys,#002244,5427,176,1987,2237,0.078676799,0.888243183,-1811,1811,-0.809566384,0.809566384
Oklahoma,OK,Beckham County,40,9,40009,Cowboys,#002244,23768,958,6287,7529,0.127241334,0.835037854,-5329,5329,-0.70779652,0.70779652
Oklahoma,OK,Blaine County,40,11,40011,Cowboys,#002244,9833,711,2884,3793,0.187450567,0.760348009,-2173,2173,-0.572897443,0.572897443
Oklahoma,OK,Bryan County,40,13,40013,Cowboys,#002244,44884,2793,10449,13775,0.202758621,0.758548094,-7656,7656,-0.555789474,0.555789474
Oklahoma,OK,Caddo County,40,15,40015,Cowboys,#002244,29343,2418,6473,9336,0.258997429,0.693337618,-4055,4055,-0.434340189,0.434340189
Oklahoma,OK,Canadian County,40,17,40017,Cowboys,#002244,133378,11666,39969,55250,0.211149321,0.723420814,-28303,28303,-0.512271493,0.512271493
Oklahoma,OK,Carter County,40,19,40019,Cowboys,#002244,48689,4002,13751,18533,0.215939136,0.741973777,-9749,9749,-0.526034641,0.526034641
Oklahoma,OK,Cherokee County,40,21,40021,Cowboys,#002244,48447,5455,9992,16487,0.330866743,0.606053254,-4537,4537,-0.275186511,0.275186511
Oklahoma,OK,Choctaw County,40,23,40023,Cowboys,#002244,14997,1064,4202,5419,0.196346189,0.775419819,-3138,3138,-0.57907363,0.57907363
Oklahoma,OK,Cimarron County,40,25,40025,Cowboys,#002244,2216,70,962,1077,0.064995357,0.893221913,-892,892,-0.828226555,0.828226555
Oklahoma,OK,Cleveland County,40,27,40027,Cowboys,#002244,274458,38790,62469,109326,0.354810384,0.571401131,-23679,23679,-0.216590747,0.216590747
Oklahoma,OK,Coal County,40,29,40029,Cowboys,#002244,5651,411,1892,2393,0.17175094,0.790639365,-1481,1481,-0.618888425,0.618888425
Oklahoma,OK,Comanche County,40,31,40031,Cowboys,#002244,124648,11439,19153,32504,0.351925917,0.589250554,-7714,7714,-0.237324637,0.237324637
Oklahoma,OK,Cotton County,40,33,40033,Cowboys,#002244,5996,424,2054,2602,0.162951576,0.789392775,-1630,1630,-0.626441199,0.626441199
Oklahoma,OK,Craig County,40,35,40035,Cowboys,#002244,14818,1249,4279,5778,0.216164763,0.74056767,-3030,3030,-0.524402908,0.524402908
Oklahoma,OK,Creek County,40,37,40037,Cowboys,#002244,70892,5834,21539,28786,0.202667964,0.748245675,-15705,15705,-0.545577711,0.545577711
Oklahoma,OK,Custer County,40,39,40039,Cowboys,#002244,29744,2102,7818,10531,0.199601177,0.742379641,-5716,5716,-0.542778464,0.542778464
Oklahoma,OK,Delaware County,40,41,40041,Cowboys,#002244,41459,3306,11796,15680,0.210841837,0.752295918,-8490,8490,-0.541454082,0.541454082
Oklahoma,OK,Dewey County,40,43,40043,Cowboys,#002244,4995,222,1964,2246,0.098842386,0.874443455,-1742,1742,-0.775601069,0.775601069
Oklahoma,OK,Ellis County,40,45,40045,Cowboys,#002244,4231,155,1610,1826,0.084884995,0.881708653,-1455,1455,-0.796823658,0.796823658
Oklahoma,OK,Garfield County,40,47,40047,Cowboys,#002244,63569,4391,15998,21692,0.202424857,0.737506915,-11607,11607,-0.535082058,0.535082058
Oklahoma,OK,Garvin County,40,49,40049,Cowboys,#002244,27755,1852,8243,10531,0.175861742,0.782736682,-6391,6391,-0.606874941,0.606874941
Oklahoma,OK,Grady County,40,51,40051,Cowboys,#002244,54648,3878,17293,22257,0.174237319,0.776969043,-13415,13415,-0.602731725,0.602731725
Oklahoma,OK,Grant County,40,53,40053,Cowboys,#002244,4523,287,1827,2200,0.130454545,0.830454545,-1540,1540,-0.7,0.7
Oklahoma,OK,Greer County,40,55,40055,Cowboys,#002244,6070,323,1482,1896,0.17035865,0.78164557,-1159,1159,-0.61128692,0.61128692
Oklahoma,OK,Harmon County,40,57,40057,Cowboys,#002244,2788,224,714,975,0.22974359,0.732307692,-490,490,-0.502564103,0.502564103
Oklahoma,OK,Harper County,40,59,40059,Cowboys,#002244,3754,131,1307,1485,0.088215488,0.88013468,-1176,1176,-0.791919192,0.791919192
Oklahoma,OK,Haskell County,40,61,40061,Cowboys,#002244,12845,882,3697,4734,0.186311787,0.780946346,-2815,2815,-0.594634559,0.594634559
Oklahoma,OK,Hughes County,40,63,40063,Cowboys,#002244,13735,961,3387,4525,0.212375691,0.748508287,-2426,2426,-0.536132597,0.536132597
Oklahoma,OK,Jackson County,40,65,40065,Cowboys,#002244,25574,1473,5969,7806,0.188700999,0.764668204,-4496,4496,-0.575967205,0.575967205
Oklahoma,OK,Jefferson County,40,67,40067,Cowboys,#002244,6276,365,1905,2345,0.15565032,0.812366738,-1540,1540,-0.656716418,0.656716418
Oklahoma,OK,Johnston County,40,69,40069,Cowboys,#002244,10980,782,3081,4001,0.195451137,0.770057486,-2299,2299,-0.574606348,0.574606348
Oklahoma,OK,Kay County,40,71,40071,Cowboys,#002244,45366,3734,12168,16795,0.222328074,0.72450134,-8434,8434,-0.502173266,0.502173266
Oklahoma,OK,Kingfisher County,40,73,40073,Cowboys,#002244,15584,783,5151,6123,0.127878491,0.841254287,-4368,4368,-0.713375796,0.713375796
Oklahoma,OK,Kiowa County,40,75,40075,Cowboys,#002244,9144,766,2593,3489,0.219547148,0.743192892,-1827,1827,-0.523645744,0.523645744
Oklahoma,OK,Latimer County,40,77,40077,Cowboys,#002244,10483,797,3094,4050,0.196790123,0.763950617,-2297,2297,-0.567160494,0.567160494
Oklahoma,OK,Le Flore County,40,79,40079,Cowboys,#002244,49605,3245,13346,17199,0.18867376,0.775975347,-10101,10101,-0.587301587,0.587301587
Oklahoma,OK,Lincoln County,40,81,40081,Cowboys,#002244,35042,2423,10838,14001,0.173059067,0.774087565,-8415,8415,-0.601028498,0.601028498
Oklahoma,OK,Logan County,40,83,40083,Cowboys,#002244,45996,4239,13613,18948,0.223717543,0.718439941,-9374,9374,-0.494722398,0.494722398
Oklahoma,OK,Love County,40,85,40085,Cowboys,#002244,9870,735,2920,3787,0.194085028,0.771058886,-2185,2185,-0.576973858,0.576973858
Oklahoma,OK,McClain County,40,87,40087,Cowboys,#002244,38066,2893,13151,16839,0.171803551,0.780984619,-10258,10258,-0.609181068,0.609181068
Oklahoma,OK,McCurtain County,40,89,40089,Cowboys,#002244,33048,1799,8642,10709,0.167989542,0.806984779,-6843,6843,-0.638995238,0.638995238
Oklahoma,OK,McIntosh County,40,91,40091,Cowboys,#002244,19990,2122,5501,7958,0.266649912,0.691254084,-3379,3379,-0.424604172,0.424604172
Oklahoma,OK,Major County,40,93,40093,Cowboys,#002244,7771,310,2940,3399,0.091203295,0.864960282,-2630,2630,-0.773756987,0.773756987
Oklahoma,OK,Marshall County,40,95,40095,Cowboys,#002244,16232,1095,4202,5487,0.199562603,0.765810097,-3107,3107,-0.566247494,0.566247494
Oklahoma,OK,Mayes County,40,97,40097,Cowboys,#002244,40887,3423,11550,15712,0.217858961,0.735106925,-8127,8127,-0.517247963,0.517247963
Oklahoma,OK,Murray County,40,99,40099,Cowboys,#002244,13936,1086,4173,5525,0.196561086,0.755294118,-3087,3087,-0.558733032,0.558733032
Oklahoma,OK,Muskogee County,40,101,40101,Cowboys,#002244,69699,7969,15029,24193,0.3293928,0.621212747,-7060,7060,-0.291819948,0.291819948
Oklahoma,OK,Noble County,40,103,40103,Cowboys,#002244,11554,901,3707,4870,0.185010267,0.761190965,-2806,2806,-0.576180698,0.576180698
Oklahoma,OK,Nowata County,40,105,40105,Cowboys,#002244,10539,742,3321,4237,0.175123908,0.783809299,-2579,2579,-0.608685391,0.608685391
Oklahoma,OK,Okfuskee County,40,107,40107,Cowboys,#002244,12181,943,2791,3933,0.239766082,0.70963641,-1848,1848,-0.469870328,0.469870328
Oklahoma,OK,Oklahoma County,40,109,40109,Cowboys,#002244,776864,112661,141429,273609,0.411759116,0.516901856,-28768,28768,-0.10514274,0.10514274
Oklahoma,OK,Okmulgee County,40,111,40111,Cowboys,#002244,39187,4379,8926,13924,0.314492962,0.641051422,-4547,4547,-0.32655846,0.32655846
Oklahoma,OK,Osage County,40,113,40113,Cowboys,#002244,47887,5593,12559,18942,0.295269771,0.663023968,-6966,6966,-0.367754197,0.367754197
Oklahoma,OK,Ottawa County,40,115,40115,Cowboys,#002244,31981,2584,7627,10686,0.241811716,0.713737601,-5043,5043,-0.471925884,0.471925884
Oklahoma,OK,Pawnee County,40,117,40117,Cowboys,#002244,16436,1341,4716,6346,0.211314214,0.743145288,-3375,3375,-0.531831075,0.531831075
Oklahoma,OK,Payne County,40,119,40119,Cowboys,#002244,80850,8785,16644,27749,0.316587985,0.599805398,-7859,7859,-0.283217413,0.283217413
Oklahoma,OK,Pittsburg County,40,121,40121,Cowboys,#002244,44610,3704,12740,17250,0.214724638,0.738550725,-9036,9036,-0.523826087,0.523826087
Oklahoma,OK,Pontotoc County,40,123,40123,Cowboys,#002244,38194,3633,10420,14814,0.245240988,0.703388686,-6787,6787,-0.458147698,0.458147698
Oklahoma,OK,Pottawatomie County,40,125,40125,Cowboys,#002244,71875,6005,17826,25417,0.236259197,0.701341622,-11821,11821,-0.465082425,0.465082425
Oklahoma,OK,Pushmataha County,40,127,40127,Cowboys,#002244,11183,748,3581,4483,0.166852554,0.798795449,-2833,2833,-0.631942895,0.631942895
Oklahoma,OK,Roger Mills County,40,129,40129,Cowboys,#002244,3788,151,1546,1758,0.08589306,0.879408419,-1395,1395,-0.793515358,0.793515358
Oklahoma,OK,Rogers County,40,131,40131,Cowboys,#002244,90802,7895,30893,40834,0.193343782,0.756550913,-22998,22998,-0.563207131,0.563207131
Oklahoma,OK,Seminole County,40,133,40133,Cowboys,#002244,25548,2067,5612,8032,0.257345618,0.698705179,-3545,3545,-0.441359562,0.441359562
Oklahoma,OK,Sequoyah County,40,135,40135,Cowboys,#002244,41153,3061,10888,14437,0.212024659,0.754173305,-7827,7827,-0.542148646,0.542148646
Oklahoma,OK,Stephens County,40,137,40137,Cowboys,#002244,44581,3084,14166,17886,0.172425361,0.792016102,-11082,11082,-0.619590741,0.619590741
Oklahoma,OK,Texas County,40,139,40139,Cowboys,#002244,21489,855,4615,5771,0.148154566,0.799688096,-3760,3760,-0.65153353,0.65153353
Oklahoma,OK,Tillman County,40,141,40141,Cowboys,#002244,7515,657,1944,2706,0.242793792,0.718403548,-1287,1287,-0.475609756,0.475609756
Oklahoma,OK,Tulsa County,40,143,40143,Cowboys,#002244,639242,87663,143985,246557,0.355548616,0.583982608,-56322,56322,-0.228433993,0.228433993
Oklahoma,OK,Wagoner County,40,145,40145,Cowboys,#002244,76559,6711,22967,31246,0.214779492,0.735038085,-16256,16256,-0.520258593,0.520258593
Oklahoma,OK,Washington County,40,147,40147,Cowboys,#002244,52021,5047,15810,22208,0.227260447,0.71190562,-10763,10763,-0.484645173,0.484645173
Oklahoma,OK,Washita County,40,149,40149,Cowboys,#002244,11661,588,3851,4628,0.127052723,0.832108902,-3263,3263,-0.70505618,0.70505618
Oklahoma,OK,Woods County,40,151,40151,Cowboys,#002244,9304,521,2945,3665,0.142155525,0.803547067,-2424,2424,-0.661391542,0.661391542
Oklahoma,OK,Woodward County,40,153,40153,Cowboys,#002244,21559,871,6329,7573,0.115013865,0.835732207,-5458,5458,-0.720718341,0.720718341
Oregon,OR,Baker County,41,1,41001,Seahawks,#69be28,16005,1781,6160,8479,0.210048355,0.726500767,-4379,4379,-0.516452412,0.516452412
Oregon,OR,Benton County,41,3,41003,Seahawks,#69be28,87572,28431,13030,45577,0.623801479,0.285889813,15401,-15401,0.337911666,-0.337911666
Oregon,OR,Clackamas County,41,5,41005,Seahawks,#69be28,401515,90187,79062,182136,0.495162955,0.434082224,11125,-11125,0.061080731,-0.061080731
Oregon,OR,Clatsop County,41,7,41007,Seahawks,#69be28,37831,8899,7794,18158,0.490087014,0.429232294,1105,-1105,0.06085472,-0.06085472
Oregon,OR,Columbia County,41,9,41009,Seahawks,#69be28,49600,9959,12967,25077,0.397136819,0.517087371,-3008,3008,-0.119950552,0.119950552
Oregon,OR,Coos County,41,11,41011,Seahawks,#69be28,63121,10355,17699,30181,0.34309665,0.586428548,-7344,7344,-0.243331898,0.243331898
Oregon,OR,Crook County,41,13,41013,Seahawks,#69be28,21630,2591,8388,11638,0.222632755,0.720742396,-5797,5797,-0.498109641,0.498109641
Oregon,OR,Curry County,41,15,41015,49ers,#aa0000,22483,4253,7157,12163,0.349667023,0.588423909,-2904,2904,-0.238756886,0.238756886
Oregon,OR,Deschutes County,41,17,41017,Seahawks,#69be28,175268,40222,43667,90584,0.444029851,0.48206085,-3445,3445,-0.038030999,0.038030999
Oregon,OR,Douglas County,41,19,41019,Seahawks,#69be28,107685,13891,34112,51350,0.270516066,0.664303797,-20221,20221,-0.393787731,0.393787731
Oregon,OR,Gilliam County,41,21,41021,Seahawks,#69be28,1859,221,632,937,0.235859125,0.674493063,-411,411,-0.438633938,0.438633938
Oregon,OR,Grant County,41,23,41023,Seahawks,#69be28,7185,732,3187,4171,0.175497483,0.764085351,-2455,2455,-0.588587869,0.588587869
Oregon,OR,Harney County,41,25,41025,Seahawks,#69be28,7200,682,2904,3850,0.177142857,0.754285714,-2222,2222,-0.577142857,0.577142857
Oregon,OR,Hood River County,41,27,41027,Seahawks,#69be28,23137,6359,3223,10383,0.612443417,0.310411249,3136,-3136,0.302032168,-0.302032168
Oregon,OR,Jackson County,41,29,41029,49ers,#aa0000,212567,43550,53083,103789,0.419601306,0.511451117,-9533,9533,-0.091849811,0.091849811
Oregon,OR,Jefferson County,41,31,41031,Seahawks,#69be28,22666,2892,5337,8874,0.325895876,0.601419878,-2445,2445,-0.275524003,0.275524003
Oregon,OR,Josephine County,41,33,41033,49ers,#aa0000,84745,13223,26582,42613,0.310304367,0.623800249,-13359,13359,-0.313495882,0.313495882
Oregon,OR,Klamath County,41,35,41035,49ers,#aa0000,66016,7080,20170,29240,0.242134063,0.689808482,-13090,13090,-0.447674419,0.447674419
Oregon,OR,Lake County,41,37,41037,49ers,#aa0000,7829,628,3001,3814,0.164656529,0.786837965,-2373,2373,-0.622181437,0.622181437
Oregon,OR,Lane County,41,39,41039,Seahawks,#69be28,362895,100497,66218,181072,0.555011266,0.365699832,34279,-34279,0.189311434,-0.189311434
Oregon,OR,Lincoln County,41,41,41041,Seahawks,#69be28,47038,12300,9901,24035,0.511753693,0.411940919,2399,-2399,0.099812773,-0.099812773
Oregon,OR,Linn County,41,43,41043,Seahawks,#69be28,120547,17456,32683,54724,0.318982531,0.597233389,-15227,15227,-0.278250859,0.278250859
Oregon,OR,Malheur County,41,45,41045,Cowboys,#002244,30380,2213,7141,9950,0.22241206,0.717688442,-4928,4928,-0.495276382,0.495276382
Oregon,OR,Marion County,41,47,41047,Seahawks,#69be28,330700,48803,54336,110804,0.440444388,0.490379409,-5533,5533,-0.04993502,0.04993502
Oregon,OR,Morrow County,41,49,41049,Seahawks,#69be28,11190,1004,2698,3989,0.251692153,0.67635999,-1694,1694,-0.424667837,0.424667837
Oregon,OR,Multnomah County,41,51,41051,Seahawks,#69be28,790294,271754,63055,357762,0.759594367,0.176248456,208699,-208699,0.583345912,-0.583345912
Oregon,OR,Polk County,41,53,41053,Seahawks,#69be28,79391,15741,18333,37030,0.425087767,0.495085066,-2592,2592,-0.069997299,0.069997299
Oregon,OR,Sherman County,41,55,41055,Seahawks,#69be28,1680,202,726,983,0.205493388,0.738555443,-524,524,-0.533062055,0.533062055
Oregon,OR,Tillamook County,41,57,41057,Seahawks,#69be28,25653,5701,6486,13261,0.429907247,0.489103386,-785,785,-0.059196139,0.059196139
Oregon,OR,Umatilla County,41,59,41059,Seahawks,#69be28,76531,7466,16775,26116,0.285878389,0.642326543,-9309,9309,-0.356448154,0.356448154
Oregon,OR,Union County,41,61,41061,Seahawks,#69be28,25790,3221,8378,12465,0.25840353,0.672121941,-5157,5157,-0.413718412,0.413718412
Oregon,OR,Wallowa County,41,63,41063,Seahawks,#69be28,6856,1097,2825,4177,0.262628681,0.67632272,-1728,1728,-0.413694039,0.413694039
Oregon,OR,Wasco County,41,65,41065,Seahawks,#69be28,25775,4634,5721,11251,0.4118745,0.508488134,-1087,1087,-0.096613634,0.096613634
Oregon,OR,Washington County,41,67,41067,Seahawks,#69be28,574326,137818,75903,232034,0.593956058,0.327120163,61915,-61915,0.266835895,-0.266835895
Oregon,OR,Wheeler County,41,69,41069,Seahawks,#69be28,1358,153,583,792,0.193181818,0.736111111,-430,430,-0.542929293,0.542929293
Oregon,OR,Yamhill County,41,71,41071,Seahawks,#69be28,102659,18635,22589,45116,0.413046369,0.500687118,-3954,3954,-0.087640748,0.087640748
Pennsylvania,PA,Adams County,42,1,42001,Steelers,#ffb612,102295,14077,31249,47138,0.298633799,0.662925877,-17172,17172,-0.364292079,0.364292079
Pennsylvania,PA,Allegheny County,42,3,42003,Steelers,#ffb612,1230459,363017,257488,643173,0.564415795,0.400340188,105529,-105529,0.164075606,-0.164075606
Pennsylvania,PA,Armstrong County,42,5,42005,Steelers,#ffb612,67052,6849,22676,30446,0.224955659,0.744794062,-15827,15827,-0.519838402,0.519838402
Pennsylvania,PA,Beaver County,42,7,42007,Steelers,#ffb612,168871,30225,46081,79036,0.382420669,0.583038109,-15856,15856,-0.20061744,0.20061744
Pennsylvania,PA,Bedford County,42,9,42009,Steelers,#ffb612,48586,3613,19455,23504,0.153718516,0.82773145,-15842,15842,-0.674012934,0.674012934
Pennsylvania,PA,Berks County,42,11,42011,Eagles,#004953,415271,75169,93094,175934,0.427256812,0.52914161,-17925,17925,-0.101884798,0.101884798
Pennsylvania,PA,Blair County,42,13,42013,Steelers,#ffb612,125593,13093,37224,52029,0.251648119,0.715447154,-24131,24131,-0.463799035,0.463799035
Pennsylvania,PA,Bradford County,42,15,42015,Steelers,#ffb612,61281,6263,17957,25399,0.246584511,0.706996338,-11694,11694,-0.460411827,0.460411827
Pennsylvania,PA,Bucks County,42,17,42017,Eagles,#004953,627367,165861,163873,342572,0.484163913,0.478360753,1988,-1988,0.00580316,-0.00580316
Pennsylvania,PA,Butler County,42,19,42019,Steelers,#ffb612,186818,26834,61388,92027,0.291588338,0.6670651,-34554,34554,-0.375476762,0.375476762
Pennsylvania,PA,Cambria County,42,21,42021,Steelers,#ffb612,136411,17798,40510,60167,0.295809996,0.673292669,-22712,22712,-0.377482673,0.377482673
Pennsylvania,PA,Cameron County,42,23,42023,Steelers,#ffb612,4732,469,1495,2024,0.231719368,0.738636364,-1026,1026,-0.506916996,0.506916996
Pennsylvania,PA,Carbon County,42,25,42025,Eagles,#004953,63960,8917,18714,28721,0.310469691,0.651578984,-9797,9797,-0.341109293,0.341109293
Pennsylvania,PA,Centre County,42,27,42027,Steelers,#ffb612,160580,36555,35099,75394,0.484852906,0.465541024,1456,-1456,0.019311882,-0.019311882
Pennsylvania,PA,Chester County,42,29,42029,Eagles,#004953,515939,140188,115582,266637,0.525763491,0.433480725,24606,-24606,0.092282766,-0.092282766
Pennsylvania,PA,Clarion County,42,31,42031,Steelers,#ffb612,39498,4256,12545,17481,0.243464333,0.717636291,-8289,8289,-0.474171958,0.474171958
Pennsylvania,PA,Clearfield County,42,33,42033,Steelers,#ffb612,80994,7700,23909,32692,0.235531629,0.731341001,-16209,16209,-0.495809372,0.495809372
Pennsylvania,PA,Clinton County,42,35,42035,Steelers,#ffb612,39441,4533,9701,14839,0.305478806,0.653750253,-5168,5168,-0.348271447,0.348271447
Pennsylvania,PA,Columbia County,42,37,42037,Steelers,#ffb612,66672,8502,17387,27127,0.313414679,0.640948133,-8885,8885,-0.327533454,0.327533454
Pennsylvania,PA,Crawford County,42,39,42039,Steelers,#ffb612,86484,10215,23912,35563,0.287236735,0.67238422,-13697,13697,-0.385147485,0.385147485
Pennsylvania,PA,Cumberland County,42,41,42041,Steelers,#ffb612,246338,44282,65649,115068,0.384833316,0.570523517,-21367,21367,-0.185690201,0.185690201
Pennsylvania,PA,Dauphin County,42,43,42043,Steelers,#ffb612,272983,64287,60620,130160,0.493907498,0.465734481,3667,-3667,0.028173018,-0.028173018
Pennsylvania,PA,Delaware County,42,45,42045,Eagles,#004953,563894,169169,106559,284832,0.593925542,0.374111757,62610,-62610,0.219813785,-0.219813785
Pennsylvania,PA,Elk County,42,47,42047,Steelers,#ffb612,30872,3637,9704,13854,0.262523459,0.700447524,-6067,6067,-0.437924065,0.437924065
Pennsylvania,PA,Erie County,42,49,42049,Steelers,#ffb612,278045,54820,57168,117240,0.467587854,0.487615148,-2348,2348,-0.020027294,0.020027294
Pennsylvania,PA,Fayette County,42,51,42051,Steelers,#ffb612,133628,17826,34388,53426,0.33365777,0.643656647,-16562,16562,-0.309998877,0.309998877
Pennsylvania,PA,Forest County,42,53,42053,Steelers,#ffb612,7410,626,1680,2398,0.261050876,0.70058382,-1054,1054,-0.439532944,0.439532944
Pennsylvania,PA,Franklin County,42,55,42055,Steelers,#ffb612,153638,17322,49554,69345,0.249794506,0.714600909,-32232,32232,-0.464806403,0.464806403
Pennsylvania,PA,Fulton County,42,57,42057,Steelers,#ffb612,14629,904,5676,6743,0.134064956,0.841761827,-4772,4772,-0.707696871,0.707696871
Pennsylvania,PA,Greene County,42,59,42059,Steelers,#ffb612,37519,4157,10394,14955,0.277967235,0.695018388,-6237,6237,-0.417051153,0.417051153
Pennsylvania,PA,Huntingdon County,42,61,42061,Steelers,#ffb612,45668,4487,14369,19496,0.230149774,0.737022979,-9882,9882,-0.506873205,0.506873205
Pennsylvania,PA,Indiana County,42,63,42063,Steelers,#ffb612,86966,11468,24920,37728,0.303965225,0.660517388,-13452,13452,-0.356552163,0.356552163
Pennsylvania,PA,Jefferson County,42,65,42065,Steelers,#ffb612,44430,3437,14533,18551,0.185273031,0.783407903,-11096,11096,-0.598134871,0.598134871
Pennsylvania,PA,Juniata County,42,67,42067,Steelers,#ffb612,24737,1810,8234,10402,0.174004999,0.791578543,-6424,6424,-0.617573544,0.617573544
Pennsylvania,PA,Lackawanna County,42,69,42069,Steelers,#ffb612,211917,51593,48102,102740,0.502170528,0.468191551,3491,-3491,0.033978976,-0.033978976
Pennsylvania,PA,Lancaster County,42,71,42071,Eagles,#004953,536624,90066,137145,239151,0.376607248,0.573466136,-47079,47079,-0.196858888,0.196858888
Pennsylvania,PA,Lawrence County,42,73,42073,Steelers,#ffb612,88082,13933,25323,40555,0.343558131,0.624411293,-11390,11390,-0.280853162,0.280853162
Pennsylvania,PA,Lebanon County,42,75,42075,Eagles,#004953,137067,17860,38804,58906,0.303194921,0.65874444,-20944,20944,-0.35554952,0.35554952
Pennsylvania,PA,Lehigh County,42,77,42077,Eagles,#004953,360685,77087,70285,153031,0.503734537,0.459286027,6802,-6802,0.04444851,-0.04444851
Pennsylvania,PA,Luzerne County,42,79,42079,Steelers,#ffb612,318449,51454,77508,132731,0.387656237,0.583947985,-26054,26054,-0.196291748,0.196291748
Pennsylvania,PA,Lycoming County,42,81,42081,Steelers,#ffb612,116048,12926,35475,50294,0.257008788,0.705352527,-22549,22549,-0.448343739,0.448343739
Pennsylvania,PA,McKean County,42,83,42083,Steelers,#ffb612,42412,3802,11159,15572,0.244156178,0.71660673,-7357,7357,-0.472450552,0.472450552
Pennsylvania,PA,Mercer County,42,85,42085,Steelers,#ffb612,114234,17631,30034,49594,0.355506715,0.605597451,-12403,12403,-0.250090737,0.250090737
Pennsylvania,PA,Mifflin County,42,87,42087,Steelers,#ffb612,46500,3563,14050,18239,0.195350622,0.770327321,-10487,10487,-0.574976698,0.574976698
Pennsylvania,PA,Monroe County,42,89,42089,Giants,#0b2265,166397,31930,31706,65944,0.484198714,0.480801893,224,-224,0.003396822,-0.003396822
Pennsylvania,PA,Montgomery County,42,91,42091,Eagles,#004953,819264,251063,160803,427489,0.587296983,0.376157047,90260,-90260,0.211139936,-0.211139936
Pennsylvania,PA,Montour County,42,93,42093,Steelers,#ffb612,18557,2851,5274,8535,0.334036321,0.617926186,-2423,2423,-0.283889865,0.283889865
Pennsylvania,PA,Northampton County,42,95,42095,Eagles,#004953,300813,65936,71384,142775,0.461817545,0.499975486,-5448,5448,-0.038157941,0.038157941
Pennsylvania,PA,Northumberland County,42,97,42097,Steelers,#ffb612,93246,9184,24418,34971,0.262617597,0.698235681,-15234,15234,-0.435618084,0.435618084
Pennsylvania,PA,Perry County,42,99,42099,Steelers,#ffb612,45685,4630,15613,21153,0.218881483,0.738098615,-10983,10983,-0.519217132,0.519217132
Pennsylvania,PA,Philadelphia County,42,101,42101,Eagles,#004953,1567442,560542,105418,680227,0.824051383,0.154974736,455124,-455124,0.669076646,-0.669076646
Pennsylvania,PA,Pike County,42,103,42103,Giants,#0b2265,55949,9247,16035,26066,0.354753318,0.615169186,-6788,6788,-0.260415867,0.260415867
Pennsylvania,PA,Potter County,42,105,42105,Steelers,#ffb612,17093,1300,6247,7777,0.167159573,0.803266041,-4947,4947,-0.636106468,0.636106468
Pennsylvania,PA,Schuylkill County,42,107,42107,Eagles,#004953,144590,16724,43937,62750,0.266517928,0.700191235,-27213,27213,-0.433673307,0.433673307
Pennsylvania,PA,Snyder County,42,109,42109,Steelers,#ffb612,40444,3991,11710,16333,0.244351926,0.716953407,-7719,7719,-0.472601482,0.472601482
Pennsylvania,PA,Somerset County,42,111,42111,Steelers,#ffb612,75522,7367,27347,35730,0.206185278,0.765379233,-19980,19980,-0.559193955,0.559193955
Pennsylvania,PA,Sullivan County,42,113,42113,Steelers,#ffb612,6328,756,2318,3168,0.238636364,0.731691919,-1562,1562,-0.493055556,0.493055556
Pennsylvania,PA,Susquehanna County,42,115,42115,Steelers,#ffb612,41666,5065,13295,19200,0.263802083,0.692447917,-8230,8230,-0.428645833,0.428645833
Pennsylvania,PA,Tioga County,42,117,42117,Steelers,#ffb612,41877,3642,12928,17334,0.210107304,0.745817469,-9286,9286,-0.535710165,0.535710165
Pennsylvania,PA,Union County,42,119,42119,Steelers,#ffb612,44954,6138,10605,17400,0.352758621,0.609482759,-4467,4467,-0.256724138,0.256724138
Pennsylvania,PA,Venango County,42,121,42121,Steelers,#ffb612,53119,5889,15254,22096,0.266518827,0.690351195,-9365,9365,-0.423832368,0.423832368
Pennsylvania,PA,Warren County,42,123,42123,Steelers,#ffb612,40396,4828,12032,17624,0.273944621,0.682705402,-7204,7204,-0.408760781,0.408760781
Pennsylvania,PA,Washington County,42,125,42125,Steelers,#ffb612,208261,34436,58941,96945,0.355211718,0.607983908,-24505,24505,-0.25277219,0.25277219
Pennsylvania,PA,Wayne County,42,127,42127,Steelers,#ffb612,51198,6398,15269,22365,0.286071987,0.682718533,-8871,8871,-0.396646546,0.396646546
Pennsylvania,PA,Westmoreland County,42,129,42129,Steelers,#ffb612,357956,59506,116427,181740,0.327423792,0.640623968,-56921,56921,-0.313200176,0.313200176
Pennsylvania,PA,Wyoming County,42,131,42131,Steelers,#ffb612,27800,3573,8375,12418,0.287727492,0.674424223,-4802,4802,-0.386696731,0.386696731
Pennsylvania,PA,York County,42,133,42133,Steelers,#ffb612,442867,67428,126933,203153,0.331907479,0.624814795,-59505,59505,-0.292907316,0.292907316
Rhode Island,RI,Bristol County,44,1,44001,Patriots,#c60c30,49084,14532,8910,24691,0.588554534,0.360860232,5622,-5622,0.227694302,-0.227694302
Rhode Island,RI,Kent County,44,3,44003,Patriots,#c60c30,164801,37582,38141,79691,0.471596542,0.478611136,-559,559,-0.007014594,0.007014594
Rhode Island,RI,Newport County,44,5,44005,Patriots,#c60c30,82423,22680,14975,39761,0.570408189,0.376625336,7705,-7705,0.193782853,-0.193782853
Rhode Island,RI,Providence County,44,7,44007,Patriots,#c60c30,633473,141597,90321,241818,0.585551944,0.373508176,51276,-51276,0.212043768,-0.212043768
Rhode Island,RI,Washington County,44,9,44009,Patriots,#c60c30,126517,33511,27074,64160,0.522303616,0.421976309,6437,-6437,0.100327307,-0.100327307
South Carolina,SC,Abbeville County,45,1,45001,Panthers,#0085ca,24932,3712,6742,10724,0.3461395,0.628683327,-3030,3030,-0.282543827,0.282543827
South Carolina,SC,Aiken County,45,3,45003,Falcons,#a71930,165829,25426,45981,74773,0.340042529,0.614941222,-20555,20555,-0.274898693,0.274898693
South Carolina,SC,Allendale County,45,5,45005,Cowboys,#002244,9433,2722,788,3578,0.760760201,0.220234768,1934,-1934,0.540525433,-0.540525433
South Carolina,SC,Anderson County,45,7,45007,Panthers,#0085ca,194692,21040,56109,80296,0.262030487,0.698777025,-35069,35069,-0.436746538,0.436746538
South Carolina,SC,Bamberg County,45,9,45009,Cowboys,#002244,14880,3886,2197,6195,0.627280065,0.354640839,1689,-1689,0.272639225,-0.272639225
South Carolina,SC,Barnwell County,45,11,45011,Steelers,#ffb612,21725,4395,4888,9479,0.463656504,0.51566621,-493,493,-0.052009706,0.052009706
South Carolina,SC,Beaufort County,45,13,45013,Steelers,#ffb612,179589,29577,39986,72770,0.406444964,0.549484678,-10409,10409,-0.143039714,0.143039714
South Carolina,SC,Berkeley County,45,15,45015,Steelers,#ffb612,202786,30492,44223,78919,0.386370836,0.560359356,-13731,13731,-0.17398852,0.17398852
South Carolina,SC,Calhoun County,45,17,45017,Panthers,#0085ca,14781,3569,3785,7553,0.472527473,0.501125381,-216,216,-0.028597908,0.028597908
South Carolina,SC,Charleston County,45,19,45019,Panthers,#0085ca,389262,89048,75233,175850,0.506386125,0.427824851,13815,-13815,0.078561274,-0.078561274
South Carolina,SC,Cherokee County,45,21,45021,Panthers,#0085ca,56194,6089,15165,21754,0.279902547,0.697113175,-9076,9076,-0.417210628,0.417210628
South Carolina,SC,Chester County,45,23,45023,Panthers,#0085ca,32267,6582,7272,14202,0.463455851,0.512040558,-690,690,-0.048584706,0.048584706
South Carolina,SC,Chesterfield County,45,25,45025,Panthers,#0085ca,46017,7125,9576,17128,0.415985521,0.55908454,-2451,2451,-0.143099019,0.143099019
South Carolina,SC,Clarendon County,45,27,45027,Steelers,#ffb612,33775,7635,7246,15156,0.503760887,0.478094484,389,-389,0.025666403,-0.025666403
South Carolina,SC,Colleton County,45,29,45029,Panthers,#0085ca,37731,7616,9083,17231,0.44199408,0.527131333,-1467,1467,-0.085137253,0.085137253
South Carolina,SC,Darlington County,45,31,45031,Cowboys,#002244,67548,13866,14973,29636,0.467876906,0.505230126,-1107,1107,-0.037353219,0.037353219
South Carolina,SC,Dillon County,45,33,45033,Cowboys,#002244,31234,5832,5637,11696,0.498632011,0.481959644,195,-195,0.016672367,-0.016672367
South Carolina,SC,Dorchester County,45,35,45035,Steelers,#ffb612,152478,24010,34932,62463,0.384387557,0.559243072,-10922,10922,-0.174855514,0.174855514
South Carolina,SC,Edgefield County,45,37,45037,Cowboys,#002244,26514,4491,6842,11644,0.385692202,0.587598763,-2351,2351,-0.201906561,0.201906561
South Carolina,SC,Fairfield County,45,39,45039,Panthers,#0085ca,22747,6936,4024,11252,0.616423747,0.357625311,2912,-2912,0.258798436,-0.258798436
South Carolina,SC,Florence County,45,41,45041,Cowboys,#002244,138900,26630,29498,57770,0.460965899,0.510611044,-2868,2868,-0.049645145,0.049645145
South Carolina,SC,Georgetown County,45,43,45043,Panthers,#0085ca,61298,13234,17334,31519,0.419873727,0.549953996,-4100,4100,-0.130080269,0.130080269
South Carolina,SC,Greenville County,45,45,45045,Panthers,#0085ca,491863,73338,125595,211572,0.34663377,0.593627701,-52257,52257,-0.246993931,0.246993931
South Carolina,SC,Greenwood County,45,47,45047,Panthers,#0085ca,69838,10633,16881,28600,0.371783217,0.590244755,-6248,6248,-0.218461538,0.218461538
South Carolina,SC,Hampton County,45,49,45049,Cowboys,#002244,20049,5163,3483,8794,0.587104844,0.396065499,1680,-1680,0.191039345,-0.191039345
South Carolina,SC,Horry County,45,51,45051,Panthers,#0085ca,309199,36731,83819,124503,0.295021004,0.673228758,-47088,47088,-0.378207754,0.378207754
South Carolina,SC,Jasper County,45,53,45053,Steelers,#ffb612,27824,7789,6100,14216,0.54790377,0.429093979,1689,-1689,0.118809792,-0.118809792
South Carolina,SC,Kershaw County,45,55,45055,Panthers,#0085ca,63603,10293,17464,28875,0.356467532,0.604813853,-7171,7171,-0.24834632,0.24834632
South Carolina,SC,Lancaster County,45,57,45057,Panthers,#0085ca,85842,13718,23598,38717,0.354314642,0.609499703,-9880,9880,-0.255185061,0.255185061
South Carolina,SC,Laurens County,45,59,45059,Panthers,#0085ca,66623,8845,16770,26474,0.334101382,0.633451688,-7925,7925,-0.299350306,0.299350306
South Carolina,SC,Lee County,45,61,45061,Steelers,#ffb612,17896,5170,2789,8110,0.637484587,0.343896424,2381,-2381,0.293588163,-0.293588163
South Carolina,SC,Lexington County,45,63,45063,Panthers,#0085ca,281833,35143,79866,121829,0.288461696,0.6555582,-44723,44723,-0.367096504,0.367096504
South Carolina,SC,McCormick County,45,65,45065,Cowboys,#002244,9706,2479,2651,5215,0.47535954,0.508341323,-172,172,-0.032981783,0.032981783
South Carolina,SC,Marion County,45,67,45067,Panthers,#0085ca,31747,8522,5434,14217,0.599423226,0.382218471,3088,-3088,0.217204755,-0.217204755
South Carolina,SC,Marlboro County,45,69,45069,Panthers,#0085ca,27494,5928,4257,10353,0.572587656,0.411185164,1671,-1671,0.161402492,-0.161402492
South Carolina,SC,Newberry County,45,71,45071,Panthers,#0085ca,38012,6212,10011,16795,0.369871986,0.596070259,-3799,3799,-0.226198273,0.226198273
South Carolina,SC,Oconee County,45,73,45073,Panthers,#0085ca,75713,7979,24096,33530,0.237966001,0.718640024,-16117,16117,-0.480674023,0.480674023
South Carolina,SC,Orangeburg County,45,75,45075,Steelers,#ffb612,89208,26258,11909,38824,0.676334226,0.306743252,14349,-14349,0.369590975,-0.369590975
South Carolina,SC,Pickens County,45,77,45077,Panthers,#0085ca,121691,10327,36096,48871,0.211311412,0.738597532,-25769,25769,-0.527286121,0.527286121
South Carolina,SC,Richland County,45,79,45079,Panthers,#0085ca,407051,108401,52753,169400,0.639911452,0.311410862,55648,-55648,0.32850059,-0.32850059
South Carolina,SC,Saluda County,45,81,45081,Cowboys,#002244,20053,2809,5525,8559,0.328192546,0.645519336,-2716,2716,-0.317326791,0.317326791
South Carolina,SC,Spartanburg County,45,83,45083,Panthers,#0085ca,297302,39888,76101,120793,0.330217811,0.630011673,-36213,36213,-0.299793862,0.299793862
South Carolina,SC,Sumter County,45,85,45085,Steelers,#ffb612,107480,24024,18733,44048,0.545405013,0.425286052,5291,-5291,0.120118961,-0.120118961
South Carolina,SC,Union County,45,87,45087,Panthers,#0085ca,27777,4727,7058,12087,0.391081327,0.583933151,-2331,2331,-0.192851824,0.192851824
South Carolina,SC,Williamsburg County,45,89,45089,Cowboys,#002244,32535,9949,4863,15049,0.66110705,0.323144395,5086,-5086,0.337962655,-0.337962655
South Carolina,SC,York County,45,91,45091,Panthers,#0085ca,251195,41230,66245,113425,0.36350011,0.584042319,-25015,25015,-0.220542209,0.220542209
South Dakota,SD,Aurora County,46,3,46003,Vikings,#4f2683,2733,340,974,1407,0.241648898,0.692253021,-634,634,-0.450604122,0.450604122
South Dakota,SD,Beadle County,46,5,46005,Vikings,#4f2683,18372,1912,4455,6772,0.282339043,0.657855877,-2543,2543,-0.375516834,0.375516834
South Dakota,SD,Bennett County,46,7,46007,Broncos,#fb4f14,3423,412,666,1149,0.358572672,0.579634465,-254,254,-0.221061793,0.221061793
South Dakota,SD,Bon Homme County,46,9,46009,Vikings,#4f2683,6985,704,2105,2974,0.236718225,0.707800941,-1401,1401,-0.471082717,0.471082717
South Dakota,SD,Brookings County,46,11,46011,Vikings,#4f2683,33897,4879,6748,12680,0.38477918,0.532176656,-1869,1869,-0.147397476,0.147397476
South Dakota,SD,Brown County,46,13,46013,Vikings,#4f2683,38785,5452,9613,16113,0.33836033,0.596599019,-4161,4161,-0.258238689,0.258238689
South Dakota,SD,Brule County,46,15,46015,Vikings,#4f2683,5281,571,1565,2288,0.249562937,0.684003497,-994,994,-0.434440559,0.434440559
South Dakota,SD,Buffalo County,46,17,46017,Broncos,#fb4f14,2095,296,171,490,0.604081633,0.348979592,125,-125,0.255102041,-0.255102041
South Dakota,SD,Butte County,46,19,46019,Broncos,#fb4f14,10283,693,3355,4346,0.159456972,0.771974229,-2662,2662,-0.612517257,0.612517257
South Dakota,SD,Campbell County,46,21,46021,Vikings,#4f2683,1397,105,704,831,0.126353791,0.847172082,-599,599,-0.720818291,0.720818291
South Dakota,SD,Charles Mix County,46,23,46023,Vikings,#4f2683,9383,935,2382,3433,0.272356539,0.693853772,-1447,1447,-0.421497233,0.421497233
South Dakota,SD,Clark County,46,25,46025,Vikings,#4f2683,3659,398,1139,1657,0.24019312,0.687386844,-741,741,-0.447193724,0.447193724
South Dakota,SD,Clay County,46,27,46027,Vikings,#4f2683,13964,2608,2109,5069,0.514499901,0.416058394,499,-499,0.098441507,-0.098441507
South Dakota,SD,Codington County,46,29,46029,Vikings,#4f2683,27939,3174,7764,11669,0.272002742,0.665352644,-4590,4590,-0.393349901,0.393349901
South Dakota,SD,Corson County,46,31,46031,Broncos,#fb4f14,4197,535,588,1175,0.455319149,0.500425532,-53,53,-0.045106383,0.045106383
South Dakota,SD,Custer County,46,33,46033,Broncos,#fb4f14,8446,1120,3290,4716,0.237489398,0.697625106,-2170,2170,-0.460135708,0.460135708
South Dakota,SD,Davison County,46,35,46035,Vikings,#4f2683,19858,2355,5157,7952,0.296151911,0.648516097,-2802,2802,-0.352364185,0.352364185
South Dakota,SD,Day County,46,37,46037,Vikings,#4f2683,5539,974,1627,2747,0.35456862,0.59228249,-653,653,-0.23771387,0.23771387
South Dakota,SD,Deuel County,46,39,46039,Vikings,#4f2683,4333,570,1366,2080,0.274038462,0.656730769,-796,796,-0.382692308,0.382692308
South Dakota,SD,Dewey County,46,41,46041,Broncos,#fb4f14,5685,887,723,1707,0.519625073,0.423550088,164,-164,0.096074985,-0.096074985
South Dakota,SD,Douglas County,46,43,46043,Vikings,#4f2683,2977,214,1338,1605,0.133333333,0.83364486,-1124,1124,-0.700311526,0.700311526
South Dakota,SD,Edmunds County,46,45,46045,Vikings,#4f2683,3999,380,1433,1918,0.198123045,0.74713243,-1053,1053,-0.549009385,0.549009385
South Dakota,SD,Fall River County,46,47,46047,Broncos,#fb4f14,6867,821,2511,3563,0.2304238,0.704743194,-1690,1690,-0.474319394,0.474319394
South Dakota,SD,Faulk County,46,49,46049,Vikings,#4f2683,2337,204,858,1118,0.182468694,0.76744186,-654,654,-0.584973166,0.584973166
South Dakota,SD,Grant County,46,51,46051,Vikings,#4f2683,7142,970,2381,3562,0.272318922,0.668444694,-1411,1411,-0.396125772,0.396125772
South Dakota,SD,Gregory County,46,53,46053,Vikings,#4f2683,4201,391,1600,2091,0.18699187,0.765184122,-1209,1209,-0.578192253,0.578192253
South Dakota,SD,Haakon County,46,55,46055,Broncos,#fb4f14,1861,77,936,1044,0.073754789,0.896551724,-859,859,-0.822796935,0.822796935
South Dakota,SD,Hamlin County,46,57,46057,Vikings,#4f2683,6047,555,2051,2762,0.200941347,0.742577842,-1496,1496,-0.541636495,0.541636495
South Dakota,SD,Hand County,46,59,46059,Vikings,#4f2683,3348,334,1391,1818,0.183718372,0.765126513,-1057,1057,-0.581408141,0.581408141
South Dakota,SD,Hanson County,46,61,46061,Vikings,#4f2683,3385,424,1497,2006,0.211365902,0.746261216,-1073,1073,-0.534895314,0.534895314
South Dakota,SD,Harding County,46,63,46063,Broncos,#fb4f14,1267,38,694,769,0.049414824,0.902470741,-656,656,-0.853055917,0.853055917
South Dakota,SD,Hughes County,46,65,46065,Vikings,#4f2683,17555,2449,5174,8173,0.299645173,0.633060076,-2725,2725,-0.333414903,0.333414903
South Dakota,SD,Hutchinson County,46,67,46067,Vikings,#4f2683,7301,692,2517,3365,0.20564636,0.747994056,-1825,1825,-0.542347697,0.542347697
South Dakota,SD,Hyde County,46,69,46069,Vikings,#4f2683,1397,125,543,690,0.18115942,0.786956522,-418,418,-0.605797101,0.605797101
South Dakota,SD,Jackson County,46,71,46071,Broncos,#fb4f14,3321,323,722,1095,0.294977169,0.659360731,-399,399,-0.364383562,0.364383562
South Dakota,SD,Jerauld County,46,73,46073,Vikings,#4f2683,1997,264,648,967,0.273009307,0.670113754,-384,384,-0.397104447,0.397104447
South Dakota,SD,Jones County,46,75,46075,Vikings,#4f2683,924,69,450,558,0.123655914,0.806451613,-381,381,-0.682795699,0.682795699
South Dakota,SD,Kingsbury County,46,77,46077,Vikings,#4f2683,4990,703,1680,2551,0.275578205,0.658565269,-977,977,-0.382987064,0.382987064
South Dakota,SD,Lake County,46,79,46079,Vikings,#4f2683,12622,2314,4038,6786,0.340996169,0.59504863,-1724,1724,-0.254052461,0.254052461
South Dakota,SD,Lawrence County,46,81,46081,Broncos,#fb4f14,24827,3356,7411,11842,0.283398075,0.625823341,-4055,4055,-0.342425266,0.342425266
South Dakota,SD,Lincoln County,46,83,46083,Vikings,#4f2683,52849,8076,15499,25231,0.320082438,0.614284016,-7423,7423,-0.294201577,0.294201577
South Dakota,SD,Lyman County,46,85,46085,Vikings,#4f2683,3876,369,977,1421,0.259676284,0.687543983,-608,608,-0.427867699,0.427867699
South Dakota,SD,McCook County,46,87,46087,Vikings,#4f2683,5599,623,1794,2587,0.240819482,0.693467337,-1171,1171,-0.452647855,0.452647855
South Dakota,SD,McPherson County,46,89,46089,Vikings,#4f2683,2415,192,892,1137,0.168865435,0.784520668,-700,700,-0.615655233,0.615655233
South Dakota,SD,Marshall County,46,91,46091,Vikings,#4f2683,4769,754,1056,1947,0.387262455,0.542372881,-302,302,-0.155110426,0.155110426
South Dakota,SD,Meade County,46,93,46093,Broncos,#fb4f14,26986,2223,8441,11621,0.191291627,0.726357456,-6218,6218,-0.535065829,0.535065829
South Dakota,SD,Mellette County,46,95,46095,Broncos,#fb4f14,2050,238,402,683,0.348462665,0.588579795,-164,164,-0.24011713,0.24011713
South Dakota,SD,Miner County,46,97,46097,Vikings,#4f2683,2236,281,706,1064,0.264097744,0.663533835,-425,425,-0.39943609,0.39943609
South Dakota,SD,Minnehaha County,46,99,46099,Vikings,#4f2683,185197,30610,42043,78263,0.391117131,0.537201487,-11433,11433,-0.146084357,0.146084357
South Dakota,SD,Moody County,46,101,46101,Vikings,#4f2683,6430,1042,1729,2930,0.355631399,0.590102389,-687,687,-0.23447099,0.23447099
South Dakota,SD,Oglala County,46,102,46102,Broncos,#fb4f14,0,2504,241,2896,0.864640884,0.083218232,2263,-2263,0.781422652,-0.781422652
South Dakota,SD,Pennington County,46,103,46103,Broncos,#fb4f14,108702,14074,29804,47741,0.29479902,0.624285206,-15730,15730,-0.329486186,0.329486186
South Dakota,SD,Perkins County,46,105,46105,Broncos,#fb4f14,3019,188,1333,1606,0.117061021,0.830012453,-1145,1145,-0.712951432,0.712951432
South Dakota,SD,Potter County,46,107,46107,Vikings,#4f2683,2320,215,1069,1335,0.161048689,0.800749064,-854,854,-0.639700375,0.639700375
South Dakota,SD,Roberts County,46,109,46109,Vikings,#4f2683,10311,1539,2142,3886,0.396037056,0.55120947,-603,603,-0.155172414,0.155172414
South Dakota,SD,Sanborn County,46,111,46111,Vikings,#4f2683,2355,241,819,1123,0.21460374,0.729296527,-578,578,-0.514692787,0.514692787
South Dakota,SD,#N/A,46,113,46113,Vikings,#4f2683,#N/A,#N/A,#N/A,#N/A,#N/A,#N/A,#N/A,#N/A,#N/A,#N/A
South Dakota,SD,Spink County,46,115,46115,Vikings,#4f2683,6524,919,1854,2951,0.311419858,0.628261606,-935,935,-0.316841749,0.316841749
South Dakota,SD,Stanley County,46,117,46117,Broncos,#fb4f14,2954,329,1148,1567,0.209955329,0.732610083,-819,819,-0.522654754,0.522654754
South Dakota,SD,Sully County,46,119,46119,Vikings,#4f2683,1426,137,679,861,0.159117305,0.788617886,-542,542,-0.629500581,0.629500581
South Dakota,SD,Todd County,46,121,46121,Broncos,#fb4f14,9959,1505,487,2125,0.708235294,0.229176471,1018,-1018,0.479058824,-0.479058824
South Dakota,SD,Tripp County,46,123,46123,Broncos,#fb4f14,5434,462,2069,2630,0.175665399,0.786692015,-1607,1607,-0.611026616,0.611026616
South Dakota,SD,Turner County,46,125,46125,Vikings,#4f2683,8209,961,2937,4150,0.231566265,0.707710843,-1976,1976,-0.476144578,0.476144578
South Dakota,SD,Union County,46,127,46127,Vikings,#4f2683,14909,2227,5288,7895,0.282077264,0.669791007,-3061,3061,-0.387713743,0.387713743
South Dakota,SD,Walworth County,46,129,46129,Vikings,#4f2683,5443,457,1896,2477,0.184497376,0.765442067,-1439,1439,-0.580944691,0.580944691
South Dakota,SD,Yankton County,46,135,46135,Vikings,#4f2683,22702,3301,5654,9616,0.34328203,0.587978369,-2353,2353,-0.244696339,0.244696339
South Dakota,SD,Ziebach County,46,137,46137,Broncos,#fb4f14,2803,352,368,766,0.459530026,0.480417755,-16,16,-0.020887728,0.020887728
Tennessee,TN,Anderson County,47,1,47001,Titans,#c60c30,75749,9010,19201,29723,0.303132254,0.645998049,-10191,10191,-0.342865794,0.342865794
Tennessee,TN,Bedford County,47,3,47003,Titans,#c60c30,47183,3384,11455,15300,0.221176471,0.74869281,-8071,8071,-0.52751634,0.52751634
Tennessee,TN,Benton County,47,5,47005,Titans,#c60c30,16129,1474,4715,6322,0.233154065,0.745808289,-3241,3241,-0.512654223,0.512654223
Tennessee,TN,Bledsoe County,47,7,47007,Titans,#c60c30,14502,896,3621,4650,0.192688172,0.778709677,-2725,2725,-0.586021505,0.586021505
Tennessee,TN,Blount County,47,9,47009,Titans,#c60c30,127253,12085,37385,51849,0.233080677,0.721036086,-25300,25300,-0.487955409,0.487955409
Tennessee,TN,Bradley County,47,11,47011,Titans,#c60c30,104091,7070,29761,38392,0.184152949,0.775187539,-22691,22691,-0.591034591,0.591034591
Tennessee,TN,Campbell County,47,13,47013,Titans,#c60c30,39752,2248,9860,12504,0.17978247,0.788547665,-7612,7612,-0.608765195,0.608765195
Tennessee,TN,Cannon County,47,15,47015,Titans,#c60c30,13840,1126,4006,5299,0.212492923,0.755991697,-2880,2880,-0.543498773,0.543498773
Tennessee,TN,Carroll County,47,17,47017,Titans,#c60c30,27910,2323,7731,10333,0.224813704,0.748185425,-5408,5408,-0.523371722,0.523371722
Tennessee,TN,Carter County,47,19,47019,Cowboys,#002244,56486,3453,16897,20993,0.164483399,0.804887343,-13444,13444,-0.640403944,0.640403944
Tennessee,TN,Cheatham County,47,21,47021,Titans,#c60c30,39741,3877,11295,15823,0.245023068,0.713834292,-7418,7418,-0.468811224,0.468811224
Tennessee,TN,Chester County,47,23,47023,Titans,#c60c30,17471,902,3827,4850,0.185979381,0.789072165,-2925,2925,-0.603092784,0.603092784
Tennessee,TN,Claiborne County,47,25,47025,Titans,#c60c30,31709,1831,8589,10706,0.171025593,0.802260415,-6758,6758,-0.631234822,0.631234822
Tennessee,TN,Clay County,47,27,47027,Titans,#c60c30,7771,707,2140,2919,0.242206235,0.733127783,-1433,1433,-0.490921548,0.490921548
Tennessee,TN,Cocke County,47,29,47029,Titans,#c60c30,35162,1980,9791,12108,0.163528246,0.808638916,-7811,7811,-0.645110671,0.645110671
Tennessee,TN,Coffee County,47,31,47031,Titans,#c60c30,54277,4741,14409,19895,0.238301081,0.724252325,-9668,9668,-0.485951244,0.485951244
Tennessee,TN,Crockett County,47,33,47033,Titans,#c60c30,14601,1302,3977,5386,0.241737839,0.738395841,-2675,2675,-0.496658002,0.496658002
Tennessee,TN,Cumberland County,47,35,47035,Titans,#c60c30,58229,5202,20410,26298,0.197809719,0.776104647,-15208,15208,-0.578294927,0.578294927
Tennessee,TN,Davidson County,47,37,47037,Titans,#c60c30,678889,148473,84365,246199,0.603060939,0.342669954,64108,-64108,0.260390985,-0.260390985
Tennessee,TN,Decatur County,47,39,47039,Titans,#c60c30,11660,894,3580,4577,0.195324448,0.782171728,-2686,2686,-0.58684728,0.58684728
Tennessee,TN,DeKalb County,47,41,47041,Titans,#c60c30,19182,1566,5164,6940,0.225648415,0.744092219,-3598,3598,-0.518443804,0.518443804
Tennessee,TN,Dickson County,47,43,47043,Titans,#c60c30,51487,4718,13213,18619,0.253397068,0.709651431,-8495,8495,-0.456254364,0.456254364
Tennessee,TN,Dyer County,47,45,47045,Titans,#c60c30,37893,2815,10175,13290,0.211813394,0.765613243,-7360,7360,-0.55379985,0.55379985
Tennessee,TN,Fayette County,47,47,47047,Titans,#c60c30,39165,5865,13046,19306,0.303791567,0.675748472,-7181,7181,-0.371956905,0.371956905
Tennessee,TN,Fentress County,47,49,47049,Titans,#c60c30,17917,1100,6032,7311,0.150458214,0.825058132,-4932,4932,-0.674599918,0.674599918
Tennessee,TN,Franklin County,47,51,47051,Titans,#c60c30,41449,4372,11526,16363,0.267188168,0.70439406,-7154,7154,-0.437205891,0.437205891
Tennessee,TN,Gibson County,47,53,47053,Titans,#c60c30,49399,5255,13779,19484,0.269708479,0.707195648,-8524,8524,-0.437487169,0.437487169
Tennessee,TN,Giles County,47,55,47055,Titans,#c60c30,28946,2915,7964,11120,0.262140288,0.71618705,-5049,5049,-0.454046763,0.454046763
Tennessee,TN,Grainger County,47,57,47057,Titans,#c60c30,22846,1154,6618,7985,0.144520977,0.828804008,-5464,5464,-0.684283031,0.684283031
Tennessee,TN,Greene County,47,59,47059,Titans,#c60c30,68580,4211,18538,23491,0.179260142,0.789153293,-14327,14327,-0.609893151,0.609893151
Tennessee,TN,Grundy County,47,61,47061,Titans,#c60c30,13441,998,3626,4750,0.210105263,0.763368421,-2628,2628,-0.553263158,0.553263158
Tennessee,TN,Hamblen County,47,63,47063,Titans,#c60c30,63402,4075,15839,20579,0.198017396,0.769668108,-11764,11764,-0.571650712,0.571650712
Tennessee,TN,Hamilton County,47,65,47065,Titans,#c60c30,354098,55260,78661,141088,0.391670447,0.55753147,-23401,23401,-0.165861023,0.165861023
Tennessee,TN,Hancock County,47,67,47067,Titans,#c60c30,6572,322,1842,2229,0.144459399,0.826379542,-1520,1520,-0.681920144,0.681920144
Tennessee,TN,Hardeman County,47,69,47069,Titans,#c60c30,25707,4174,4912,9242,0.451633845,0.531486691,-738,738,-0.079852846,0.079852846
Tennessee,TN,Hardin County,47,71,47071,Titans,#c60c30,25756,1622,8012,9949,0.16303146,0.805307066,-6390,6390,-0.642275606,0.642275606
Tennessee,TN,Hawkins County,47,73,47073,Titans,#c60c30,56471,3502,16611,20694,0.169227795,0.802696434,-13109,13109,-0.633468638,0.633468638
Tennessee,TN,Haywood County,47,75,47075,Titans,#c60c30,18023,3704,3010,6824,0.542790152,0.44109027,694,-694,0.101699883,-0.101699883
Tennessee,TN,Henderson County,47,77,47077,Titans,#c60c30,28015,1796,8118,10172,0.176563114,0.798073142,-6322,6322,-0.621510028,0.621510028
Tennessee,TN,Henry County,47,79,47079,Titans,#c60c30,32147,3061,9483,12887,0.237526189,0.735857841,-6422,6422,-0.498331652,0.498331652
Tennessee,TN,Hickman County,47,81,47081,Titans,#c60c30,24363,1823,5685,7762,0.234862149,0.732414326,-3862,3862,-0.497552177,0.497552177
Tennessee,TN,Houston County,47,83,47083,Titans,#c60c30,8149,865,2180,3165,0.273301738,0.68878357,-1315,1315,-0.415481833,0.415481833
Tennessee,TN,Humphreys County,47,85,47085,Titans,#c60c30,18135,1967,4928,7139,0.275528786,0.690292758,-2961,2961,-0.414763973,0.414763973
Tennessee,TN,Jackson County,47,87,47087,Titans,#c60c30,11509,1129,3229,4447,0.25387902,0.726107488,-2100,2100,-0.472228469,0.472228469
Tennessee,TN,Jefferson County,47,89,47089,Titans,#c60c30,53240,3490,14760,18994,0.183742234,0.777087501,-11270,11270,-0.593345267,0.593345267
Tennessee,TN,Johnson County,47,91,47091,Cowboys,#002244,17830,988,5400,6556,0.150701647,0.823672971,-4412,4412,-0.672971324,0.672971324
Tennessee,TN,Knox County,47,93,47093,Titans,#c60c30,451324,62861,105724,179266,0.350657682,0.589760468,-42863,42863,-0.239102786,0.239102786
Tennessee,TN,Lake County,47,95,47095,Titans,#c60c30,7576,577,1357,1970,0.292893401,0.688832487,-780,780,-0.395939086,0.395939086
Tennessee,TN,Lauderdale County,47,97,47097,Titans,#c60c30,26936,3656,4884,8678,0.421295229,0.562802489,-1228,1228,-0.14150726,0.14150726
Tennessee,TN,Lawrence County,47,99,47099,Titans,#c60c30,42564,2821,12419,15658,0.180163495,0.793140886,-9598,9598,-0.612977392,0.612977392
Tennessee,TN,Lewis County,47,101,47101,Titans,#c60c30,11854,890,3579,4601,0.19343621,0.777874375,-2689,2689,-0.584438166,0.584438166
Tennessee,TN,Lincoln County,47,103,47103,Titans,#c60c30,33743,2550,10375,13270,0.192162773,0.781838734,-7825,7825,-0.589675961,0.589675961
Tennessee,TN,Loudon County,47,105,47105,Titans,#c60c30,51130,4916,17588,23304,0.21095091,0.75472022,-12672,12672,-0.54376931,0.54376931
Tennessee,TN,McMinn County,47,107,47107,Titans,#c60c30,52639,3507,14673,18694,0.1876003,0.784904247,-11166,11166,-0.597303948,0.597303948
Tennessee,TN,McNairy County,47,109,47109,Titans,#c60c30,26066,1847,7839,10035,0.184055805,0.781165919,-5992,5992,-0.597110115,0.597110115
Tennessee,TN,Macon County,47,111,47111,Titans,#c60c30,23177,1071,6260,7490,0.142990654,0.835781041,-5189,5189,-0.692790387,0.692790387
Tennessee,TN,Madison County,47,113,47113,Titans,#c60c30,97610,15438,21321,37764,0.408802034,0.564585319,-5883,5883,-0.155783286,0.155783286
Tennessee,TN,Marion County,47,115,47115,Titans,#c60c30,28487,2829,7680,10832,0.261170606,0.70901034,-4851,4851,-0.447839734,0.447839734
Tennessee,TN,Marshall County,47,117,47117,Titans,#c60c30,31552,2848,8167,11402,0.24978074,0.716277846,-5319,5319,-0.466497106,0.466497106
Tennessee,TN,Maury County,47,119,47119,Titans,#c60c30,87757,10026,23781,35068,0.285901677,0.678139614,-13755,13755,-0.392237938,0.392237938
Tennessee,TN,Meigs County,47,121,47121,Titans,#c60c30,11830,856,3337,4311,0.198561819,0.774066342,-2481,2481,-0.575504523,0.575504523
Tennessee,TN,Monroe County,47,123,47123,Titans,#c60c30,45771,3184,13361,17050,0.186744868,0.783636364,-10177,10177,-0.596891496,0.596891496
Tennessee,TN,Montgomery County,47,125,47125,Titans,#c60c30,193479,21686,32320,57278,0.378609588,0.564265512,-10634,10634,-0.185655924,0.185655924
Tennessee,TN,Moore County,47,127,47127,Titans,#c60c30,6322,496,2325,2926,0.169514696,0.794600137,-1829,1829,-0.625085441,0.625085441
Tennessee,TN,Morgan County,47,129,47129,Titans,#c60c30,21498,1053,5429,6664,0.158013205,0.81467587,-4376,4376,-0.656662665,0.656662665
Tennessee,TN,Obion County,47,131,47131,Titans,#c60c30,30639,2425,9525,12223,0.198396466,0.779268592,-7100,7100,-0.580872126,0.580872126
Tennessee,TN,Overton County,47,133,47133,Titans,#c60c30,22129,1943,6055,8195,0.23709579,0.738865162,-4112,4112,-0.501769372,0.501769372
Tennessee,TN,Perry County,47,135,47135,Titans,#c60c30,7929,597,2167,2855,0.20910683,0.759019264,-1570,1570,-0.549912434,0.549912434
Tennessee,TN,Pickett County,47,137,47137,Titans,#c60c30,5146,536,2019,2609,0.205442698,0.773859716,-1483,1483,-0.568417018,0.568417018
Tennessee,TN,Polk County,47,139,47139,Titans,#c60c30,16773,1252,5097,6520,0.19202454,0.781748466,-3845,3845,-0.589723926,0.589723926
Tennessee,TN,Putnam County,47,141,47141,Titans,#c60c30,74553,6847,18981,26958,0.253987685,0.704095259,-12134,12134,-0.450107575,0.450107575
Tennessee,TN,Rhea County,47,143,47143,Titans,#c60c30,32526,1942,8650,10946,0.177416408,0.790243011,-6708,6708,-0.612826603,0.612826603
Tennessee,TN,Roane County,47,145,47145,Titans,#c60c30,52753,4833,15863,21580,0.223957368,0.735078777,-11030,11030,-0.511121409,0.511121409
Tennessee,TN,Robertson County,47,147,47147,Titans,#c60c30,68570,6634,19393,27042,0.245322092,0.717143702,-12759,12759,-0.471821611,0.471821611
Tennessee,TN,Rutherford County,47,149,47149,Titans,#c60c30,298612,36627,64428,106518,0.343857376,0.604855517,-27801,27801,-0.260998141,0.260998141
Tennessee,TN,Scott County,47,151,47151,Titans,#c60c30,21950,934,6044,7123,0.131124526,0.848518882,-5110,5110,-0.717394356,0.717394356
Tennessee,TN,Sequatchie County,47,153,47153,Titans,#c60c30,14811,1051,4434,5667,0.185459679,0.782424563,-3383,3383,-0.596964884,0.596964884
Tennessee,TN,Sevier County,47,155,47155,Titans,#c60c30,95946,6293,28610,36180,0.173935876,0.79076838,-22317,22317,-0.616832504,0.616832504
Tennessee,TN,Shelby County,47,157,47157,Cowboys,#002244,938069,206640,114948,331861,0.622670335,0.346373934,91692,-91692,0.276296401,-0.276296401
Tennessee,TN,Smith County,47,159,47159,Titans,#c60c30,19295,1688,5485,7410,0.22780027,0.740215924,-3797,3797,-0.512415655,0.512415655
Tennessee,TN,Stewart County,47,161,47161,Titans,#c60c30,13259,1222,3864,5283,0.231307969,0.731402612,-2642,2642,-0.500094643,0.500094643
Tennessee,TN,Sullivan County,47,163,47163,Titans,#c60c30,156791,11910,45577,59860,0.19896425,0.761393251,-33667,33667,-0.562429001,0.562429001
Tennessee,TN,Sumner County,47,165,47165,Titans,#c60c30,175989,18153,50105,71080,0.255388295,0.704909961,-31952,31952,-0.449521666,0.449521666
Tennessee,TN,Tipton County,47,167,47167,Titans,#c60c30,61870,5779,16893,23372,0.247261681,0.722787951,-11114,11114,-0.475526271,0.475526271
Tennessee,TN,Trousdale County,47,169,47169,Titans,#c60c30,8042,943,2099,3142,0.300127307,0.668045831,-1156,1156,-0.367918523,0.367918523
Tennessee,TN,Unicoi County,47,171,47171,Cowboys,#002244,17860,1260,5666,7166,0.17583031,0.790678203,-4406,4406,-0.614847893,0.614847893
Tennessee,TN,Union County,47,173,47173,Titans,#c60c30,19119,1010,5024,6204,0.162798195,0.809800129,-4014,4014,-0.647001934,0.647001934
Tennessee,TN,Van Buren County,47,175,47175,Titans,#c60c30,5677,539,1820,2417,0.223003724,0.752999586,-1281,1281,-0.529995863,0.529995863
Tennessee,TN,Warren County,47,177,47177,Titans,#c60c30,40435,3535,9535,13565,0.260597125,0.702911906,-6000,6000,-0.442314781,0.442314781
Tennessee,TN,Washington County,47,179,47179,Titans,#c60c30,126302,13003,34179,49411,0.263160025,0.691728562,-21176,21176,-0.428568537,0.428568537
Tennessee,TN,Wayne County,47,181,47181,Titans,#c60c30,16748,717,5034,5842,0.122731941,0.861691202,-4317,4317,-0.738959261,0.738959261
Tennessee,TN,Weakley County,47,183,47183,Titans,#c60c30,33960,2770,9001,12127,0.228415931,0.742228086,-6231,6231,-0.513812155,0.513812155
Tennessee,TN,White County,47,185,47185,Titans,#c60c30,26521,1842,7657,9776,0.188420622,0.783244681,-5815,5815,-0.594824059,0.594824059
Tennessee,TN,Williamson County,47,187,47187,Titans,#c60c30,211672,30992,68160,104700,0.296007641,0.651002865,-37168,37168,-0.354995224,0.354995224
Tennessee,TN,Wilson County,47,189,47189,Titans,#c60c30,128911,14356,39304,56286,0.255054543,0.698290872,-24948,24948,-0.443236329,0.443236329
Texas,TX,Anderson County,48,1,48001,Cowboys,#002244,57580,3358,13165,16887,0.198851187,0.77959377,-9807,9807,-0.580742583,0.580742583
Texas,TX,Andrews County,48,3,48003,Cowboys,#002244,18105,836,3925,4926,0.169711734,0.796792529,-3089,3089,-0.627080796,0.627080796
Texas,TX,Angelina County,48,5,48005,Cowboys,#002244,88255,7538,21666,29870,0.252360228,0.725343154,-14128,14128,-0.472982926,0.472982926
Texas,TX,Aransas County,48,7,48007,Cowboys,#002244,25350,2458,7730,10467,0.234833286,0.738511512,-5272,5272,-0.503678227,0.503678227
Texas,TX,Archer County,48,9,48009,Cowboys,#002244,8715,394,3785,4269,0.092293277,0.886624502,-3391,3391,-0.794331225,0.794331225
Texas,TX,Armstrong County,48,11,48011,Cowboys,#002244,1947,70,924,1017,0.068829892,0.908554572,-854,854,-0.83972468,0.83972468
Texas,TX,Atascosa County,48,13,48013,Cowboys,#002244,48435,4635,8598,13605,0.340683572,0.631973539,-3963,3963,-0.291289967,0.291289967
Texas,TX,Austin County,48,15,48015,Texans,#a71930,29563,2319,9637,12255,0.189228886,0.786372909,-7318,7318,-0.597144023,0.597144023
Texas,TX,Bailey County,48,17,48017,Cowboys,#002244,7210,397,1343,1784,0.222533632,0.752802691,-946,946,-0.530269058,0.530269058
Texas,TX,Bandera County,48,19,48019,Cowboys,#002244,21269,1726,8159,10213,0.169000294,0.798883776,-6433,6433,-0.629883482,0.629883482
Texas,TX,Bastrop County,48,21,48021,Cowboys,#002244,80527,10555,16314,28250,0.373628319,0.577486726,-5759,5759,-0.203858407,0.203858407
Texas,TX,Baylor County,48,23,48023,Cowboys,#002244,3618,191,1267,1492,0.128016086,0.84919571,-1076,1076,-0.721179625,0.721179625
Texas,TX,Bee County,48,25,48025,Cowboys,#002244,32874,3443,4743,8458,0.407070229,0.560770868,-1300,1300,-0.153700638,0.153700638
Texas,TX,Bell County,48,27,48027,Cowboys,#002244,334941,37608,51780,93999,0.400089363,0.550856924,-14172,14172,-0.150767561,0.150767561
Texas,TX,Bexar County,48,29,48029,Cowboys,#002244,1897753,319191,240161,586038,0.54465922,0.409804484,79030,-79030,0.134854736,-0.134854736
Texas,TX,Blanco County,48,31,48031,Cowboys,#002244,11004,1244,4212,5669,0.219439055,0.742988181,-2968,2968,-0.523549127,0.523549127
Texas,TX,Borden County,48,33,48033,Cowboys,#002244,648,31,330,365,0.084931507,0.904109589,-299,299,-0.819178082,0.819178082
Texas,TX,Bosque County,48,35,48035,Cowboys,#002244,17891,1277,6325,7797,0.163780941,0.81120944,-5048,5048,-0.647428498,0.647428498
Texas,TX,Bowie County,48,37,48037,Cowboys,#002244,93389,8831,24913,34470,0.256193792,0.722744415,-16082,16082,-0.466550624,0.466550624
Texas,TX,Brazoria County,48,39,48039,Texans,#a71930,346312,43075,72653,120296,0.358075081,0.603951919,-29578,29578,-0.245876837,0.245876837
Texas,TX,Brazos County,48,41,48041,Cowboys,#002244,215037,23041,38662,66036,0.348915743,0.585468532,-15621,15621,-0.236552789,0.236552789
Texas,TX,Brewster County,48,43,48043,Cowboys,#002244,9145,1869,2073,4226,0.442262186,0.490534785,-204,204,-0.048272598,0.048272598
Texas,TX,Briscoe County,48,45,48045,Cowboys,#002244,1505,91,625,734,0.123978202,0.851498638,-534,534,-0.727520436,0.727520436
Texas,TX,Brooks County,48,47,48047,Cowboys,#002244,7230,1937,613,2596,0.74614792,0.236132512,1324,-1324,0.510015408,-0.510015408
Texas,TX,Brown County,48,49,48049,Cowboys,#002244,37896,1621,12010,13949,0.116209047,0.86099362,-10389,10389,-0.744784572,0.744784572
Texas,TX,Burleson County,48,51,48051,Cowboys,#002244,17460,1491,5316,6945,0.214686825,0.765442765,-3825,3825,-0.55075594,0.55075594
Texas,TX,Burnet County,48,53,48053,Cowboys,#002244,45463,3785,14595,19046,0.198729392,0.766302636,-10810,10810,-0.567573244,0.567573244
Texas,TX,Caldwell County,48,55,48055,Cowboys,#002244,40522,4663,6516,11709,0.39824067,0.556495004,-1853,1853,-0.158254334,0.158254334
Texas,TX,Calhoun County,48,57,48057,Cowboys,#002244,21895,2118,4638,6957,0.30444157,0.666666667,-2520,2520,-0.362225097,0.362225097
Texas,TX,Callahan County,48,59,48059,Cowboys,#002244,13557,568,4858,5556,0.102231821,0.87437005,-4290,4290,-0.772138229,0.772138229
Texas,TX,Cameron County,48,61,48061,Cowboys,#002244,422156,59319,29432,91804,0.646148316,0.320596052,29887,-29887,0.325552264,-0.325552264
Texas,TX,Camp County,48,63,48063,Cowboys,#002244,12682,1260,3201,4542,0.277410832,0.704755614,-1941,1941,-0.427344782,0.427344782
Texas,TX,Carson County,48,65,48065,Cowboys,#002244,5969,249,2617,2945,0.084550085,0.888624788,-2368,2368,-0.804074703,0.804074703
Texas,TX,Cass County,48,67,48067,Cowboys,#002244,30313,2250,9182,11606,0.193865242,0.791142512,-6932,6932,-0.59727727,0.59727727
Texas,TX,Castro County,48,69,48069,Cowboys,#002244,7656,526,1413,1996,0.263527054,0.707915832,-887,887,-0.444388778,0.444388778
Texas,TX,Chambers County,48,71,48071,Texans,#a71930,38863,2939,13278,16661,0.176399976,0.796950963,-10339,10339,-0.620550987,0.620550987
Texas,TX,Cherokee County,48,73,48073,Cowboys,#002244,51542,3466,12896,16701,0.207532483,0.772169331,-9430,9430,-0.564636848,0.564636848
Texas,TX,Childress County,48,75,48075,Cowboys,#002244,7088,253,1802,2084,0.121401152,0.864683301,-1549,1549,-0.74328215,0.74328215
Texas,TX,Clay County,48,77,48077,Cowboys,#002244,10360,536,4376,5011,0.106964678,0.873278787,-3840,3840,-0.766314109,0.766314109
Texas,TX,Cochran County,48,79,48079,Cowboys,#002244,2953,190,679,901,0.210876804,0.753607103,-489,489,-0.5427303,0.5427303
Texas,TX,Coke County,48,81,48081,Cowboys,#002244,3238,140,1265,1423,0.098383696,0.888966971,-1125,1125,-0.790583275,0.790583275
Texas,TX,Coleman County,48,83,48083,Cowboys,#002244,8338,387,3177,3635,0.106464924,0.874002751,-2790,2790,-0.767537827,0.767537827
Texas,TX,Collin County,48,85,48085,Cowboys,#002244,914127,139837,200395,356545,0.392200143,0.562046866,-60558,60558,-0.169846723,0.169846723
Texas,TX,Collingsworth County,48,87,48087,Cowboys,#002244,3044,145,983,1154,0.125649913,0.851819757,-838,838,-0.726169844,0.726169844
Texas,TX,Colorado County,48,89,48089,Texans,#a71930,20870,1977,6323,8480,0.233136792,0.745636792,-4346,4346,-0.5125,0.5125
Texas,TX,Comal County,48,91,48091,Cowboys,#002244,129048,14166,44996,61567,0.230090795,0.73084607,-30830,30830,-0.500755275,0.500755275
Texas,TX,Comanche County,48,93,48093,Cowboys,#002244,13430,788,4300,5208,0.151305684,0.825652842,-3512,3512,-0.674347158,0.674347158
Texas,TX,Concho County,48,95,48095,Cowboys,#002244,4081,148,885,1067,0.138706654,0.829428304,-737,737,-0.690721649,0.690721649
Texas,TX,Cooke County,48,97,48097,Cowboys,#002244,39229,2345,13174,15894,0.147539952,0.828866239,-10829,10829,-0.681326287,0.681326287
Texas,TX,Coryell County,48,99,48099,Cowboys,#002244,75503,5057,12212,18127,0.278976113,0.673691179,-7155,7155,-0.394715066,0.394715066
Texas,TX,Cottle County,48,101,48101,Cowboys,#002244,1426,84,486,583,0.144082333,0.833619211,-402,402,-0.689536878,0.689536878
Texas,TX,Crane County,48,103,48103,Cowboys,#002244,5048,299,1047,1381,0.216509776,0.758146271,-748,748,-0.541636495,0.541636495
Texas,TX,Crockett County,48,105,48105,Cowboys,#002244,3710,372,980,1395,0.266666667,0.702508961,-608,608,-0.435842294,0.435842294
Texas,TX,Crosby County,48,107,48107,Cowboys,#002244,5977,468,1180,1712,0.273364486,0.689252336,-712,712,-0.41588785,0.41588785
Texas,TX,Culberson County,48,109,48109,Cowboys,#002244,2236,454,280,762,0.595800525,0.367454068,174,-174,0.228346457,-0.228346457
Texas,TX,Dallam County,48,111,48111,Cowboys,#002244,7121,222,1258,1535,0.144625407,0.819543974,-1036,1036,-0.674918567,0.674918567
Texas,TX,Dallas County,48,113,48113,Cowboys,#002244,2553385,458845,261865,750649,0.611264386,0.348851461,196980,-196980,0.262412925,-0.262412925
Texas,TX,Dawson County,48,115,48115,Cowboys,#002244,13520,835,2636,3562,0.234418866,0.740033689,-1801,1801,-0.505614823,0.505614823
Texas,TX,Deaf Smith County,48,117,48117,Cowboys,#002244,18952,1185,2911,4201,0.282075696,0.692930255,-1726,1726,-0.410854558,0.410854558
Texas,TX,Delta County,48,119,48119,Cowboys,#002244,5217,400,1836,2279,0.175515577,0.805616498,-1436,1436,-0.630100921,0.630100921
Texas,TX,Denton County,48,121,48121,Cowboys,#002244,780612,110000,169175,293287,0.375059242,0.576824067,-59175,59175,-0.201764824,0.201764824
Texas,TX,DeWitt County,48,123,48123,Cowboys,#002244,20797,1161,5510,6822,0.170184697,0.807681032,-4349,4349,-0.637496335,0.637496335
Texas,TX,Dickens County,48,125,48125,Cowboys,#002244,2206,128,755,909,0.140814081,0.830583058,-627,627,-0.689768977,0.689768977
Texas,TX,Dimmit County,48,127,48127,Cowboys,#002244,10980,2173,974,3225,0.67379845,0.302015504,1199,-1199,0.371782946,-0.371782946
Texas,TX,Donley County,48,129,48129,Cowboys,#002244,3499,190,1225,1460,0.130136986,0.839041096,-1035,1035,-0.70890411,0.70890411
Texas,TX,Duval County,48,131,48131,Cowboys,#002244,11388,2783,1316,4159,0.669151238,0.316422217,1467,-1467,0.352729021,-0.352729021
Texas,TX,Eastland County,48,133,48133,Cowboys,#002244,18171,776,6008,6935,0.111896179,0.866330209,-5232,5232,-0.75443403,0.75443403
Texas,TX,Ector County,48,135,48135,Cowboys,#002244,159436,10225,24976,36373,0.281115113,0.686663184,-14751,14751,-0.405548071,0.405548071
Texas,TX,Edwards County,48,137,48137,Cowboys,#002244,1894,302,741,1065,0.283568075,0.695774648,-439,439,-0.412206573,0.412206573
Texas,TX,Ellis County,48,139,48139,Cowboys,#002244,163632,16197,44807,63064,0.256834327,0.710500444,-28610,28610,-0.453666117,0.453666117
Texas,TX,El Paso County,48,141,48141,Cowboys,#002244,835593,145509,54567,210458,0.691392107,0.259277386,90942,-90942,0.432114721,-0.432114721
Texas,TX,Erath County,48,143,48143,Cowboys,#002244,41122,2159,11205,13810,0.156335988,0.811368573,-9046,9046,-0.655032585,0.655032585
Texas,TX,Falls County,48,145,48145,Cowboys,#002244,17142,1682,3438,5232,0.32148318,0.657110092,-1756,1756,-0.335626911,0.335626911
Texas,TX,Fannin County,48,147,48147,Cowboys,#002244,33693,2123,9536,11972,0.177330438,0.796525226,-7413,7413,-0.619194788,0.619194788
Texas,TX,Fayette County,48,149,48149,Cowboys,#002244,25110,2127,8648,11029,0.1928552,0.784114607,-6521,6521,-0.591259407,0.591259407
Texas,TX,Fisher County,48,151,48151,Cowboys,#002244,3827,403,1265,1722,0.234030197,0.734610918,-862,862,-0.50058072,0.50058072
Texas,TX,Floyd County,48,153,48153,Cowboys,#002244,5901,435,1473,1958,0.222165475,0.752298264,-1038,1038,-0.530132789,0.530132789
Texas,TX,Foard County,48,155,48155,Cowboys,#002244,1220,113,383,511,0.221135029,0.749510763,-270,270,-0.528375734,0.528375734
Texas,TX,Fort Bend County,48,157,48157,Texans,#a71930,716087,134475,117212,260367,0.516482504,0.450179938,17263,-17263,0.066302565,-0.066302565
Texas,TX,Franklin County,48,159,48159,Cowboys,#002244,10651,665,3583,4356,0.152662994,0.822543618,-2918,2918,-0.669880624,0.669880624
Texas,TX,Freestone County,48,161,48161,Cowboys,#002244,19691,1461,5995,7608,0.1920347,0.78798633,-4534,4534,-0.59595163,0.59595163
Texas,TX,Frio County,48,163,48163,Cowboys,#002244,18793,1401,1232,2683,0.522176668,0.459187477,169,-169,0.062989191,-0.062989191
Texas,TX,Gaines County,48,165,48165,Cowboys,#002244,20051,597,3907,4609,0.129529182,0.847689304,-3310,3310,-0.718160122,0.718160122
Texas,TX,Galveston County,48,167,48167,Texans,#a71930,322225,45503,73566,123994,0.366977434,0.593302902,-28063,28063,-0.226325467,0.226325467
Texas,TX,Garza County,48,169,48169,Cowboys,#002244,6415,224,1223,1475,0.151864407,0.829152542,-999,999,-0.677288136,0.677288136
Texas,TX,Gillespie County,48,171,48171,Cowboys,#002244,25963,2286,10445,13123,0.174197973,0.795930809,-8159,8159,-0.621732835,0.621732835
Texas,TX,Glasscock County,48,173,48173,Cowboys,#002244,1315,34,553,602,0.056478405,0.918604651,-519,519,-0.862126246,0.862126246
Texas,TX,Goliad County,48,175,48175,Cowboys,#002244,7531,973,2618,3713,0.262052249,0.705090224,-1645,1645,-0.443037975,0.443037975
Texas,TX,Gonzales County,48,177,48177,Cowboys,#002244,20573,1567,4580,6304,0.248572335,0.726522843,-3013,3013,-0.477950508,0.477950508
Texas,TX,Gray County,48,179,48179,Cowboys,#002244,23210,699,6495,7360,0.094972826,0.882472826,-5796,5796,-0.7875,0.7875
Texas,TX,Grayson County,48,181,48181,Cowboys,#002244,125467,10276,35274,47068,0.218322427,0.749426362,-24998,24998,-0.531103935,0.531103935
Texas,TX,Gregg County,48,183,48183,Cowboys,#002244,124108,11623,28693,41365,0.280986341,0.693654055,-17070,17070,-0.412667714,0.412667714
Texas,TX,Grimes County,48,185,48185,Texans,#a71930,27512,2194,7065,9528,0.230268682,0.741498741,-4871,4871,-0.511230059,0.511230059
Texas,TX,Guadalupe County,48,187,48187,Cowboys,#002244,151249,18308,36495,57220,0.319958057,0.637801468,-18187,18187,-0.317843411,0.317843411
Texas,TX,Hale County,48,189,48189,Cowboys,#002244,34360,2090,6347,8802,0.237446035,0.721086117,-4257,4257,-0.483640082,0.483640082
Texas,TX,Hall County,48,191,48191,Cowboys,#002244,3138,164,891,1089,0.150596878,0.818181818,-727,727,-0.66758494,0.66758494
Texas,TX,Hamilton County,48,193,48193,Cowboys,#002244,8159,479,3056,3609,0.132723746,0.846771959,-2577,2577,-0.714048213,0.714048213
Texas,TX,Hansford County,48,195,48195,Cowboys,#002244,5610,171,1730,1947,0.087827427,0.888546482,-1559,1559,-0.800719055,0.800719055
Texas,TX,Hardeman County,48,197,48197,Cowboys,#002244,3840,249,1207,1511,0.164791529,0.798808736,-958,958,-0.634017207,0.634017207
Texas,TX,Hardin County,48,199,48199,Cowboys,#002244,55865,2779,19600,22768,0.122057273,0.860857344,-16821,16821,-0.73880007,0.73880007
Texas,TX,Harris County,48,201,48201,Texans,#a71930,4538028,706471,544960,1302887,0.542235052,0.418271116,161511,-161511,0.123963935,-0.123963935
Texas,TX,Harrison County,48,203,48203,Cowboys,#002244,66746,7130,18712,26364,0.270444546,0.709755728,-11582,11582,-0.439311182,0.439311182
Texas,TX,Hartley County,48,205,48205,Cowboys,#002244,6193,172,1727,1945,0.088431877,0.887917738,-1555,1555,-0.799485861,0.799485861
Texas,TX,Haskell County,48,207,48207,Cowboys,#002244,5737,314,1403,1765,0.177903683,0.79490085,-1089,1089,-0.616997167,0.616997167
Texas,TX,Hays County,48,209,48209,Cowboys,#002244,194739,33117,33730,71524,0.463019406,0.471589956,-613,613,-0.00857055,0.00857055
Texas,TX,Hemphill County,48,211,48211,Cowboys,#002244,4264,181,1460,1687,0.107291049,0.865441612,-1279,1279,-0.758150563,0.758150563
Texas,TX,Henderson County,48,213,48213,Cowboys,#002244,79545,5649,23574,29855,0.189214537,0.78961648,-17925,17925,-0.600401943,0.600401943
Texas,TX,Hidalgo County,48,215,48215,Cowboys,#002244,842304,118739,48608,172990,0.686392277,0.28098734,70131,-70131,0.405404937,-0.405404937
Texas,TX,Hill County,48,217,48217,Cowboys,#002244,34855,2535,10075,12906,0.19642027,0.780644661,-7540,7540,-0.584224392,0.584224392
Texas,TX,Hockley County,48,219,48219,Cowboys,#002244,23433,1257,5793,7282,0.172617413,0.795523208,-4536,4536,-0.622905795,0.622905795
Texas,TX,Hood County,48,221,48221,Cowboys,#002244,55423,4001,21367,26120,0.153177642,0.818032159,-17366,17366,-0.664854518,0.664854518
Texas,TX,Hopkins County,48,223,48223,Cowboys,#002244,36223,2508,10704,13476,0.186108638,0.79430098,-8196,8196,-0.608192342,0.608192342
Texas,TX,Houston County,48,225,48225,Cowboys,#002244,22785,1978,6205,8302,0.238255842,0.747410263,-4227,4227,-0.509154421,0.509154421
Texas,TX,Howard County,48,227,48227,Cowboys,#002244,37206,1768,6635,8692,0.20340543,0.763345605,-4867,4867,-0.559940175,0.559940175
Texas,TX,Hudspeth County,48,229,48229,Cowboys,#002244,3379,324,503,871,0.371986223,0.57749713,-179,179,-0.205510907,0.205510907
Texas,TX,Hunt County,48,231,48231,Cowboys,#002244,89844,6301,23866,31185,0.202052269,0.765303832,-17565,17565,-0.563251563,0.563251563
Texas,TX,Hutchinson County,48,233,48233,Cowboys,#002244,21734,854,7039,8126,0.105094758,0.866231848,-6185,6185,-0.761137091,0.761137091
Texas,TX,Irion County,48,235,48235,Cowboys,#002244,1554,90,660,760,0.118421053,0.868421053,-570,570,-0.75,0.75
Texas,TX,Jack County,48,237,48237,Cowboys,#002244,8878,314,2973,3339,0.094040132,0.890386343,-2659,2659,-0.796346211,0.796346211
Texas,TX,Jackson County,48,239,48239,Texans,#a71930,14816,904,4266,5275,0.171374408,0.808720379,-3362,3362,-0.637345972,0.637345972
Texas,TX,Jasper County,48,241,48241,Cowboys,#002244,35506,2582,10578,13351,0.193393753,0.792300202,-7996,7996,-0.598906449,0.598906449
Texas,TX,Jeff Davis County,48,243,48243,Cowboys,#002244,2156,422,694,1175,0.359148936,0.590638298,-272,272,-0.231489362,0.231489362
Texas,TX,Jefferson County,48,245,48245,Cowboys,#002244,254308,42404,42828,87363,0.485377105,0.490230418,-424,424,-0.004853313,0.004853313
Texas,TX,Jim Hogg County,48,247,48247,Cowboys,#002244,5200,1635,430,2119,0.771590373,0.202925908,1205,-1205,0.568664464,-0.568664464
Texas,TX,Jim Wells County,48,249,48249,Cowboys,#002244,41382,6688,5411,12346,0.541713915,0.438279605,1277,-1277,0.103434311,-0.103434311
Texas,TX,Johnson County,48,251,48251,Cowboys,#002244,159990,10976,44370,57270,0.191653571,0.774751179,-33394,33394,-0.583097608,0.583097608
Texas,TX,Jones County,48,253,48253,Cowboys,#002244,19970,935,4815,5932,0.15761969,0.811699258,-3880,3880,-0.654079568,0.654079568
Texas,TX,Karnes County,48,255,48255,Cowboys,#002244,14975,1144,2959,4185,0.273357228,0.707048984,-1815,1815,-0.433691756,0.433691756
Texas,TX,Kaufman County,48,257,48257,Cowboys,#002244,114690,10265,29537,40979,0.250494156,0.720783816,-19272,19272,-0.470289661,0.470289661
Texas,TX,Kendall County,48,259,48259,Cowboys,#002244,40384,3633,15663,19936,0.182233146,0.785664125,-12030,12030,-0.603430979,0.603430979
Texas,TX,Kenedy County,48,261,48261,Cowboys,#002244,407,99,84,186,0.532258065,0.451612903,15,-15,0.080645161,-0.080645161
Texas,TX,Kent County,48,263,48263,Cowboys,#002244,764,59,360,433,0.136258661,0.831408776,-301,301,-0.695150115,0.695150115
Texas,TX,Kerr County,48,265,48265,Cowboys,#002244,50955,4665,17658,23090,0.202035513,0.764746644,-12993,12993,-0.56271113,0.56271113
Texas,TX,Kimble County,48,267,48267,Cowboys,#002244,4388,206,1697,1945,0.105912596,0.872493573,-1491,1491,-0.766580977,0.766580977
Texas,TX,King County,48,269,48269,Cowboys,#002244,282,5,149,159,0.031446541,0.937106918,-144,144,-0.905660377,0.905660377
Texas,TX,Kinney County,48,271,48271,Cowboys,#002244,3549,457,936,1424,0.320926966,0.657303371,-479,479,-0.336376404,0.336376404
Texas,TX,Kleberg County,48,273,48273,Cowboys,#002244,31857,4713,4364,9483,0.496994622,0.460191922,349,-349,0.0368027,-0.0368027
Texas,TX,Knox County,48,275,48275,Cowboys,#002244,3860,247,1078,1358,0.181885125,0.793814433,-831,831,-0.611929308,0.611929308
Texas,TX,Lamar County,48,277,48277,Cowboys,#002244,49440,3579,14546,18537,0.193073313,0.784700869,-10967,10967,-0.591627556,0.591627556
Texas,TX,Lamb County,48,279,48279,Cowboys,#002244,13385,770,3040,3905,0.197183099,0.778489117,-2270,2270,-0.581306018,0.581306018
Texas,TX,Lampasas County,48,281,48281,Cowboys,#002244,20588,1479,6371,8149,0.181494662,0.781813719,-4892,4892,-0.600319058,0.600319058
Texas,TX,La Salle County,48,283,48283,Cowboys,#002244,7631,1125,870,2049,0.549048316,0.424597365,255,-255,0.124450952,-0.124450952
Texas,TX,Lavaca County,48,285,48285,Cowboys,#002244,19836,1170,7339,8633,0.135526468,0.850110043,-6169,6169,-0.714583575,0.714583575
Texas,TX,Lee County,48,287,48287,Cowboys,#002244,16898,1372,4996,6522,0.210364919,0.766022692,-3624,3624,-0.555657774,0.555657774
Texas,TX,Leon County,48,289,48289,Cowboys,#002244,17086,909,6391,7407,0.12272175,0.862832456,-5482,5482,-0.740110706,0.740110706
Texas,TX,Liberty County,48,291,48291,Texans,#a71930,79654,4851,18856,24155,0.200827986,0.780625129,-14005,14005,-0.579797143,0.579797143
Texas,TX,Limestone County,48,293,48293,Cowboys,#002244,23320,1748,5747,7648,0.228556485,0.751438285,-3999,3999,-0.522881799,0.522881799
Texas,TX,Lipscomb County,48,295,48295,Cowboys,#002244,3569,135,1159,1322,0.102118003,0.876701967,-1024,1024,-0.774583964,0.774583964
Texas,TX,Live Oak County,48,297,48297,Cowboys,#002244,12229,739,3450,4267,0.173189595,0.808530584,-2711,2711,-0.635340989,0.635340989
Texas,TX,Llano County,48,299,48299,Cowboys,#002244,19796,1825,8283,10377,0.175869712,0.798207574,-6458,6458,-0.622337863,0.622337863
Texas,TX,Loving County,48,301,48301,Cowboys,#002244,112,4,57,64,0.0625,0.890625,-53,53,-0.828125,0.828125
Texas,TX,Lubbock County,48,303,48303,Cowboys,#002244,299453,27956,65566,98060,0.285090761,0.66863145,-37610,37610,-0.383540689,0.383540689
Texas,TX,Lynn County,48,305,48305,Cowboys,#002244,5724,403,1546,1997,0.201802704,0.774161242,-1143,1143,-0.572358538,0.572358538
Texas,TX,McCulloch County,48,307,48307,Cowboys,#002244,8341,480,2546,3086,0.155541154,0.825016202,-2066,2066,-0.669475049,0.669475049
Texas,TX,McLennan County,48,309,48309,Cowboys,#002244,245671,27046,48245,78255,0.345613699,0.616510127,-21199,21199,-0.270896428,0.270896428
Texas,TX,McMullen County,48,311,48311,Cowboys,#002244,820,40,454,497,0.080482897,0.913480885,-414,414,-0.832997988,0.832997988
Texas,TX,Madison County,48,313,48313,Cowboys,#002244,14065,881,3349,4283,0.205696941,0.781928555,-2468,2468,-0.576231613,0.576231613
Texas,TX,Marion County,48,315,48315,Cowboys,#002244,10160,1156,2968,4206,0.274845459,0.705658583,-1812,1812,-0.430813124,0.430813124
Texas,TX,Martin County,48,317,48317,Cowboys,#002244,5641,266,1453,1755,0.151566952,0.827920228,-1187,1187,-0.676353276,0.676353276
Texas,TX,Mason County,48,319,48319,Cowboys,#002244,4032,353,1656,2053,0.171943497,0.806624452,-1303,1303,-0.634680955,0.634680955
Texas,TX,Matagorda County,48,321,48321,Texans,#a71930,36770,3357,8147,11779,0.284998727,0.69165464,-4790,4790,-0.406655913,0.406655913
Texas,TX,Maverick County,48,323,48323,Cowboys,#002244,57706,10397,2816,13588,0.765160436,0.207241684,7581,-7581,0.557918752,-0.557918752
Texas,TX,Medina County,48,325,48325,Cowboys,#002244,48417,4624,12054,17187,0.269040554,0.701344039,-7430,7430,-0.432303485,0.432303485
Texas,TX,Menard County,48,327,48327,Cowboys,#002244,2164,153,681,860,0.177906977,0.791860465,-528,528,-0.613953488,0.613953488
Texas,TX,Midland County,48,329,48329,Cowboys,#002244,161077,9993,36896,48753,0.204972002,0.756794454,-26903,26903,-0.551822452,0.551822452
Texas,TX,Milam County,48,331,48331,Cowboys,#002244,24513,2042,6340,8607,0.237248751,0.736609736,-4298,4298,-0.499360985,0.499360985
Texas,TX,Mills County,48,333,48333,Cowboys,#002244,4900,242,1949,2238,0.108132261,0.870866845,-1707,1707,-0.762734584,0.762734584
Texas,TX,Mitchell County,48,335,48335,Cowboys,#002244,9067,353,1780,2190,0.161187215,0.812785388,-1427,1427,-0.651598174,0.651598174
Texas,TX,Montague County,48,337,48337,Cowboys,#002244,19262,885,7526,8604,0.102859135,0.874709437,-6641,6641,-0.771850302,0.771850302
Texas,TX,Montgomery County,48,339,48339,Texans,#a71930,537559,45744,150188,203083,0.225247805,0.739539991,-104444,104444,-0.514292186,0.514292186
Texas,TX,Moore County,48,341,48341,Cowboys,#002244,22255,1096,3974,5262,0.208285823,0.75522615,-2878,2878,-0.546940327,0.546940327
Texas,TX,Morris County,48,343,48343,Cowboys,#002244,12516,1425,3443,4964,0.287066882,0.693593876,-2018,2018,-0.406526994,0.406526994
Texas,TX,Motley County,48,345,48345,Cowboys,#002244,1148,40,571,620,0.064516129,0.920967742,-531,531,-0.856451613,0.856451613
Texas,TX,Nacogdoches County,48,347,48347,Cowboys,#002244,65664,6822,14751,22430,0.304146233,0.65764601,-7929,7929,-0.353499777,0.353499777
Texas,TX,Navarro County,48,349,48349,Cowboys,#002244,48323,3998,11984,16382,0.244048346,0.731534611,-7986,7986,-0.487486265,0.487486265
Texas,TX,Newton County,48,351,48351,Cowboys,#002244,13986,978,2961,4010,0.243890274,0.73840399,-1983,1983,-0.494513716,0.494513716
Texas,TX,Nolan County,48,353,48353,Cowboys,#002244,15107,1029,3551,4744,0.216905565,0.748524452,-2522,2522,-0.531618887,0.531618887
Texas,TX,Nueces County,48,355,48355,Cowboys,#002244,359715,49102,50704,103958,0.472325362,0.487735432,-1602,1602,-0.015410069,0.015410069
Texas,TX,Ochiltree County,48,357,48357,Cowboys,#002244,10747,274,2628,2981,0.091915465,0.881583361,-2354,2354,-0.789667897,0.789667897
Texas,TX,Oldham County,48,359,48359,Cowboys,#002244,2069,78,850,945,0.082539683,0.899470899,-772,772,-0.816931217,0.816931217
Texas,TX,Orange County,48,361,48361,Cowboys,#002244,84260,5716,25385,31761,0.179969145,0.799250653,-19669,19669,-0.619281509,0.619281509
Texas,TX,Palo Pinto County,48,363,48363,Cowboys,#002244,27895,1700,8222,10175,0.167076167,0.808058968,-6522,6522,-0.640982801,0.640982801
Texas,TX,Panola County,48,365,48365,Cowboys,#002244,23766,1835,8445,10413,0.17622203,0.811005474,-6610,6610,-0.634783444,0.634783444
Texas,TX,Parker County,48,367,48367,Cowboys,#002244,126042,8329,46433,56413,0.147643274,0.823090422,-38104,38104,-0.675447149,0.675447149
Texas,TX,Parmer County,48,369,48369,Cowboys,#002244,9749,848,1911,2818,0.30092264,0.678140525,-1063,1063,-0.377217885,0.377217885
Texas,TX,Pecos County,48,371,48371,Cowboys,#002244,16203,1551,2463,4167,0.372210223,0.591072714,-912,912,-0.218862491,0.218862491
Texas,TX,Polk County,48,373,48373,Texans,#a71930,46972,7123,26587,34444,0.206799443,0.771890605,-19464,19464,-0.565091162,0.565091162
Texas,TX,Potter County,48,375,48375,Cowboys,#002244,121802,7620,19499,28330,0.26897282,0.688280974,-11879,11879,-0.419308154,0.419308154
Texas,TX,Presidio County,48,377,48377,Cowboys,#002244,6876,1458,652,2203,0.661824784,0.295960054,806,-806,0.36586473,-0.36586473
Texas,TX,Rains County,48,379,48379,Cowboys,#002244,11161,619,3919,4630,0.133693305,0.846436285,-3300,3300,-0.712742981,0.712742981
Texas,TX,Randall County,48,381,48381,Cowboys,#002244,130269,8340,43379,53813,0.154981138,0.806106331,-35039,35039,-0.651125193,0.651125193
Texas,TX,Reagan County,48,383,48383,Cowboys,#002244,3792,167,709,900,0.185555556,0.787777778,-542,542,-0.602222222,0.602222222
Texas,TX,Real County,48,385,48385,Cowboys,#002244,3307,262,1382,1678,0.15613826,0.823599523,-1120,1120,-0.667461263,0.667461263
Texas,TX,Red River County,48,387,48387,Cowboys,#002244,12455,1148,3924,5147,0.223042549,0.762385856,-2776,2776,-0.539343307,0.539343307
Texas,TX,Reeves County,48,389,48389,Cowboys,#002244,14732,1659,1417,3184,0.521042714,0.445037688,242,-242,0.076005025,-0.076005025
Texas,TX,Refugio County,48,391,48391,Cowboys,#002244,7289,1034,1830,2945,0.351103565,0.62139219,-796,796,-0.270288625,0.270288625
Texas,TX,Roberts County,48,393,48393,Cowboys,#002244,916,20,524,550,0.036363636,0.952727273,-504,504,-0.916363636,0.916363636
Texas,TX,Robertson County,48,395,48395,Cowboys,#002244,16659,2203,4665,7010,0.314265335,0.665477889,-2462,2462,-0.351212553,0.351212553
Texas,TX,Rockwall County,48,397,48397,Cowboys,#002244,90861,9633,28396,39529,0.243694503,0.718358673,-18763,18763,-0.474664171,0.474664171
Texas,TX,Runnels County,48,399,48399,Cowboys,#002244,10551,452,3241,3765,0.120053121,0.860823373,-2789,2789,-0.740770252,0.740770252
Texas,TX,Rusk County,48,401,48401,Cowboys,#002244,53070,3935,14675,18994,0.207170685,0.772612404,-10740,10740,-0.565441718,0.565441718
Texas,TX,Sabine County,48,403,48403,Cowboys,#002244,10368,614,3992,4642,0.132270573,0.859974149,-3378,3378,-0.727703576,0.727703576
Texas,TX,San Augustine County,48,405,48405,Cowboys,#002244,8473,907,2620,3563,0.254560763,0.735335392,-1713,1713,-0.480774628,0.480774628
Texas,TX,San Jacinto County,48,407,48407,Texans,#a71930,27413,2034,8050,10305,0.197379913,0.781174187,-6016,6016,-0.583794275,0.583794275
Texas,TX,San Patricio County,48,409,48409,Cowboys,#002244,67357,7825,13004,21513,0.363733556,0.604471715,-5179,5179,-0.240738158,0.240738158
Texas,TX,San Saba County,48,411,48411,Cowboys,#002244,5901,293,2025,2354,0.124468989,0.860237893,-1732,1732,-0.735768904,0.735768904
Texas,TX,Schleicher County,48,413,48413,Cowboys,#002244,3211,209,819,1054,0.19829222,0.777039848,-610,610,-0.578747628,0.578747628
Texas,TX,Scurry County,48,415,48415,Cowboys,#002244,17615,733,4403,5261,0.139327124,0.836913134,-3670,3670,-0.69758601,0.69758601
Texas,TX,Shackelford County,48,417,48417,Cowboys,#002244,3350,103,1378,1502,0.068575233,0.917443409,-1275,1275,-0.848868176,0.848868176
Texas,TX,Shelby County,48,419,48419,Cowboys,#002244,25402,1757,7171,9072,0.19367284,0.790454145,-5414,5414,-0.596781305,0.596781305
Texas,TX,Sherman County,48,421,48421,Cowboys,#002244,3072,96,807,933,0.102893891,0.864951768,-711,711,-0.762057878,0.762057878
Texas,TX,Smith County,48,423,48423,Cowboys,#002244,222936,22128,58631,83161,0.266086266,0.705030002,-36503,36503,-0.438943736,0.438943736
Texas,TX,Somervell County,48,425,48425,Cowboys,#002244,8739,540,3206,3876,0.139318885,0.827141383,-2666,2666,-0.687822497,0.687822497
Texas,TX,Starr County,48,427,48427,Cowboys,#002244,63795,9246,2218,11691,0.790864768,0.189718587,7028,-7028,0.601146181,-0.601146181
Texas,TX,Stephens County,48,429,48429,Cowboys,#002244,9440,348,3033,3453,0.100781929,0.878366638,-2685,2685,-0.777584709,0.777584709
Texas,TX,Sterling County,48,431,48431,Cowboys,#002244,1352,70,549,633,0.110584518,0.867298578,-479,479,-0.75671406,0.75671406
Texas,TX,Stonewall County,48,433,48433,Cowboys,#002244,1410,135,555,701,0.192582026,0.791726106,-420,420,-0.59914408,0.59914408
Texas,TX,Sutton County,48,435,48435,Cowboys,#002244,3913,313,1075,1415,0.221201413,0.759717314,-762,762,-0.538515901,0.538515901
Texas,TX,Swisher County,48,437,48437,Cowboys,#002244,7533,462,1671,2190,0.210958904,0.763013699,-1209,1209,-0.552054795,0.552054795
Texas,TX,Tarrant County,48,439,48439,Cowboys,#002244,1982498,288001,345683,662832,0.434500748,0.521524308,-57682,57682,-0.08702356,0.08702356
Texas,TX,Taylor County,48,441,48441,Cowboys,#002244,136051,10047,33172,45266,0.221954668,0.732823753,-23125,23125,-0.510869085,0.510869085
Texas,TX,Terrell County,48,443,48443,Cowboys,#002244,837,140,287,437,0.320366133,0.656750572,-147,147,-0.336384439,0.336384439
Texas,TX,Terry County,48,445,48445,Cowboys,#002244,12739,424,1295,1763,0.240499149,0.734543392,-871,871,-0.494044243,0.494044243
Texas,TX,Throckmorton County,48,447,48447,Cowboys,#002244,1579,84,715,808,0.103960396,0.88490099,-631,631,-0.780940594,0.780940594
Texas,TX,Titus County,48,449,48449,Cowboys,#002244,32623,2538,6405,9176,0.276591107,0.698016565,-3867,3867,-0.421425458,0.421425458
Texas,TX,Tom Green County,48,451,48451,Cowboys,#002244,118105,9117,27376,38104,0.239266219,0.718454755,-18259,18259,-0.479188537,0.479188537
Texas,TX,Travis County,48,453,48453,Cowboys,#002244,1176558,306475,126750,462511,0.662632889,0.274047536,179725,-179725,0.388585353,-0.388585353
Texas,TX,Trinity County,48,455,48455,Texans,#a71930,14402,1154,4737,5982,0.19291207,0.791875627,-3583,3583,-0.598963557,0.598963557
Texas,TX,Tyler County,48,457,48457,Cowboys,#002244,21347,1243,6601,7969,0.15597942,0.828334797,-5358,5358,-0.672355377,0.672355377
Texas,TX,Upshur County,48,459,48459,Cowboys,#002244,40603,2378,13198,15918,0.149390627,0.829124262,-10820,10820,-0.679733635,0.679733635
Texas,TX,Upton County,48,461,48461,Cowboys,#002244,3651,284,961,1296,0.219135802,0.741512346,-677,677,-0.522376543,0.522376543
Texas,TX,Uvalde County,48,463,48463,Cowboys,#002244,27245,3863,4828,8936,0.432296329,0.540286482,-965,965,-0.107990152,0.107990152
Texas,TX,Val Verde County,48,465,48465,Cowboys,#002244,48988,6920,5856,13476,0.513505491,0.434550312,1064,-1064,0.07895518,-0.07895518
Texas,TX,Van Zandt County,48,467,48467,Cowboys,#002244,53547,2792,18436,21689,0.128728849,0.850016137,-15644,15644,-0.721287288,0.721287288
Texas,TX,Victoria County,48,469,48469,Cowboys,#002244,92382,8843,21253,31032,0.284963908,0.684873679,-12410,12410,-0.399909771,0.399909771
Texas,TX,Walker County,48,471,48471,Texans,#a71930,70699,6085,12878,19683,0.309150028,0.654270182,-6793,6793,-0.345120154,0.345120154
Texas,TX,Waller County,48,473,48473,Texans,#a71930,48656,5744,10525,16715,0.343643434,0.629673946,-4781,4781,-0.286030512,0.286030512
Texas,TX,Ward County,48,475,48475,Cowboys,#002244,11721,780,2541,3413,0.228537943,0.744506299,-1761,1761,-0.515968356,0.515968356
Texas,TX,Washington County,48,477,48477,Texans,#a71930,34765,3381,10944,14747,0.22926697,0.742117041,-7563,7563,-0.512850071,0.512850071
Texas,TX,Webb County,48,479,48479,Cowboys,#002244,269721,42297,12946,56867,0.743788137,0.227654,29351,-29351,0.516134138,-0.516134138
Texas,TX,Wharton County,48,481,48481,Texans,#a71930,41486,4238,10149,14707,0.2881621,0.690079554,-5911,5911,-0.401917454,0.401917454
Texas,TX,Wheeler County,48,483,48483,Cowboys,#002244,5657,194,2087,2306,0.084128361,0.905030356,-1893,1893,-0.820901995,0.820901995
Texas,TX,Wichita County,48,485,48485,Cowboys,#002244,131705,8752,27609,37913,0.230844301,0.728219872,-18857,18857,-0.49737557,0.49737557
Texas,TX,Wilbarger County,48,487,48487,Cowboys,#002244,13027,807,3166,4101,0.196781273,0.772006828,-2359,2359,-0.575225555,0.575225555
Texas,TX,Willacy County,48,489,48489,Cowboys,#002244,21903,3416,1541,5082,0.672176309,0.303227076,1875,-1875,0.368949233,-0.368949233
Texas,TX,Williamson County,48,491,48491,Cowboys,#002244,508514,84252,104029,200524,0.420159183,0.518785781,-19777,19777,-0.098626598,0.098626598
Texas,TX,Wilson County,48,493,48493,Cowboys,#002244,47520,4790,13991,19255,0.248766554,0.726616463,-9201,9201,-0.477849909,0.477849909
Texas,TX,Winkler County,48,495,48495,Cowboys,#002244,8005,420,1403,1873,0.224239188,0.74906567,-983,983,-0.524826482,0.524826482
Texas,TX,Wise County,48,497,48497,Cowboys,#002244,62953,3412,20655,24661,0.138356109,0.837557277,-17243,17243,-0.699201168,0.699201168
Texas,TX,Wood County,48,499,48499,Cowboys,#002244,43356,2624,15681,18646,0.140727234,0.840984662,-13057,13057,-0.700257428,0.700257428
Texas,TX,Yoakum County,48,501,48501,Cowboys,#002244,8546,426,1797,2299,0.185297956,0.781644193,-1371,1371,-0.596346237,0.596346237
Texas,TX,Young County,48,503,48503,Cowboys,#002244,18270,873,6587,7658,0.113998433,0.860146252,-5714,5714,-0.746147819,0.746147819
Texas,TX,Zapata County,48,505,48505,Cowboys,#002244,14374,2056,1028,3134,0.656030632,0.328015316,1028,-1028,0.328015316,-0.328015316
Texas,TX,Zavala County,48,507,48507,Cowboys,#002244,12235,2633,692,3390,0.776696165,0.204129794,1941,-1941,0.572566372,-0.572566372
Utah,UT,Beaver County,49,1,49001,Broncos,#fb4f14,6354,264,1838,2490,0.106024096,0.73815261,-1574,1574,-0.632128514,0.632128514
Utah,UT,Box Elder County,49,3,49003,Broncos,#fb4f14,52097,1814,10324,16548,0.109620498,0.62388204,-8510,8510,-0.514261542,0.514261542
Utah,UT,Cache County,49,5,49005,Broncos,#fb4f14,120783,6705,16643,35879,0.186878118,0.463864656,-9938,9938,-0.276986538,0.276986538
Utah,UT,Carbon County,49,7,49007,Broncos,#fb4f14,20479,1696,5182,7818,0.216935278,0.662829368,-3486,3486,-0.445894091,0.445894091
Utah,UT,Daggett County,49,9,49009,Broncos,#fb4f14,1109,76,327,465,0.16344086,0.703225806,-251,251,-0.539784946,0.539784946
Utah,UT,Davis County,49,11,49011,Broncos,#fb4f14,336043,22575,46985,104661,0.215696391,0.448925579,-24410,24410,-0.233229188,0.233229188
Utah,UT,Duchesne County,49,13,49013,Broncos,#fb4f14,20862,500,5505,6932,0.072129256,0.794143104,-5005,5005,-0.722013849,0.722013849
Utah,UT,Emery County,49,15,49015,Broncos,#fb4f14,10370,379,3402,4263,0.088904527,0.798029557,-3023,3023,-0.709125029,0.709125029
Utah,UT,Garfield County,49,17,49017,Broncos,#fb4f14,5009,352,1577,2294,0.153443766,0.68744551,-1225,1225,-0.534001744,0.534001744
Utah,UT,Grand County,49,19,49019,Broncos,#fb4f14,9516,1932,1934,4456,0.433572711,0.434021544,-2,2,-0.000448833,0.000448833
Utah,UT,Iron County,49,21,49021,Broncos,#fb4f14,48368,2104,10025,15354,0.137032695,0.652924319,-7921,7921,-0.515891624,0.515891624
Utah,UT,Juab County,49,23,49023,Broncos,#fb4f14,10594,436,2759,4076,0.106967615,0.676889107,-2323,2323,-0.569921492,0.569921492
Utah,UT,Kane County,49,25,49025,Broncos,#fb4f14,7131,739,2248,3482,0.212234348,0.645605974,-1509,1509,-0.433371626,0.433371626
Utah,UT,Millard County,49,27,49027,Broncos,#fb4f14,12645,431,3860,5234,0.082346198,0.737485671,-3429,3429,-0.655139473,0.655139473
Utah,UT,Morgan County,49,29,49029,Broncos,#fb4f14,11065,572,3156,5136,0.111370717,0.614485981,-2584,2584,-0.503115265,0.503115265
Utah,UT,Piute County,49,31,49031,Broncos,#fb4f14,1517,31,537,617,0.050243112,0.870340357,-506,506,-0.820097245,0.820097245
Utah,UT,Rich County,49,33,49033,Broncos,#fb4f14,2311,104,786,1096,0.094890511,0.717153285,-682,682,-0.622262774,0.622262774
Utah,UT,Salt Lake County,49,35,49035,Broncos,#fb4f14,1107314,154831,117901,361347,0.428482871,0.32628194,36930,-36930,0.102200932,-0.102200932
Utah,UT,San Juan County,49,37,49037,Broncos,#fb4f14,15772,1997,2635,5385,0.37084494,0.489322191,-638,638,-0.118477252,0.118477252
Utah,UT,Sanpete County,49,39,49039,Broncos,#fb4f14,28778,1026,6436,9778,0.104929433,0.658212313,-5410,5410,-0.55328288,0.55328288
Utah,UT,Sevier County,49,41,49041,Broncos,#fb4f14,20984,673,6455,8308,0.081006259,0.776961964,-5782,5782,-0.695955705,0.695955705
Utah,UT,Summit County,49,43,49043,Broncos,#fb4f14,39633,10251,7160,20133,0.509164059,0.355635027,3091,-3091,0.153529032,-0.153529032
Utah,UT,Tooele County,49,45,49045,Broncos,#fb4f14,62952,4015,9693,18905,0.212377678,0.512721502,-5678,5678,-0.300343824,0.300343824
Utah,UT,Uintah County,49,47,49047,Broncos,#fb4f14,37928,1002,9876,12883,0.077776915,0.766591632,-8874,8874,-0.688814717,0.688814717
Utah,UT,Utah County,49,49,49049,Broncos,#fb4f14,575205,24579,89755,174942,0.140497994,0.513055756,-65176,65176,-0.372557762,0.372557762
Utah,UT,Wasatch County,49,51,49051,Broncos,#fb4f14,29161,3063,6115,12120,0.252722772,0.504537954,-3052,3052,-0.251815182,0.251815182
Utah,UT,Washington County,49,53,49053,Broncos,#fb4f14,155602,9583,39566,57494,0.166678262,0.688176158,-29983,29983,-0.521497895,0.521497895
Utah,UT,Wayne County,49,55,49055,Broncos,#fb4f14,2692,271,959,1410,0.192198582,0.680141844,-688,688,-0.487943262,0.487943262
Utah,UT,Weber County,49,57,49057,Cowboys,#002244,243645,22187,38447,81451,0.272396901,0.472026126,-16260,16260,-0.199629225,0.199629225
Vermont,VT,Addison County,50,1,50001,Patriots,#c60c30,37035,11217,5297,17592,0.637619372,0.301102774,5920,-5920,0.336516598,-0.336516598
Vermont,VT,Bennington County,50,3,50003,Patriots,#c60c30,36317,9539,5925,16345,0.583603548,0.362496176,3614,-3614,0.221107372,-0.221107372
Vermont,VT,Caledonia County,50,5,50005,Patriots,#c60c30,30780,6445,5533,12966,0.497069258,0.426731451,912,-912,0.070337807,-0.070337807
Vermont,VT,Chittenden County,50,7,50007,Patriots,#c60c30,161382,54463,18298,77263,0.704904029,0.236827459,36165,-36165,0.46807657,-0.46807657
Vermont,VT,Essex County,50,9,50009,Patriots,#c60c30,6163,1019,1506,2706,0.376570584,0.55654102,-487,487,-0.179970436,0.179970436
Vermont,VT,Franklin County,50,11,50011,Patriots,#c60c30,48799,9351,8752,19373,0.482682083,0.451762763,599,-599,0.030919321,-0.030919321
Vermont,VT,Grand Isle County,50,13,50013,Patriots,#c60c30,6861,2094,1487,3778,0.554261514,0.393594494,607,-607,0.16066702,-0.16066702
Vermont,VT,Lamoille County,50,15,50015,Patriots,#c60c30,25235,7241,3570,11641,0.622025599,0.306674684,3671,-3671,0.315350915,-0.315350915
Vermont,VT,Orange County,50,17,50017,Patriots,#c60c30,28899,7522,4997,13464,0.558674985,0.371137849,2525,-2525,0.187537136,-0.187537136
Vermont,VT,Orleans County,50,19,50019,Patriots,#c60c30,27100,5181,5158,10988,0.471514379,0.469421187,23,-23,0.002093193,-0.002093193
Vermont,VT,Rutland County,50,21,50021,Patriots,#c60c30,59736,13629,12471,27660,0.492733189,0.450867679,1158,-1158,0.04186551,-0.04186551
Vermont,VT,Washington County,50,23,50023,Patriots,#c60c30,58612,18594,7993,28654,0.648914637,0.278948838,10601,-10601,0.369965799,-0.369965799
Vermont,VT,Windham County,50,25,50025,Patriots,#c60c30,43386,14340,5462,21151,0.677982129,0.258238381,8878,-8878,0.419743747,-0.419743747
Vermont,VT,Windsor County,50,27,50027,Patriots,#c60c30,55737,17544,8604,27832,0.63035355,0.309140558,8940,-8940,0.321212992,-0.321212992
Virginia,VA,Accomack County,51,1,51001,Redskins,#773141,32973,6737,8582,15755,0.427610282,0.544715963,-1845,1845,-0.117105681,0.117105681
Virginia,VA,Albemarle County,51,3,51003,Redskins,#773141,105703,33297,19232,56134,0.593169915,0.342608758,14065,-14065,0.250561157,-0.250561157
Virginia,VA,Alleghany County,51,5,51005,Redskins,#773141,15677,2165,4873,7306,0.296331782,0.666986039,-2708,2708,-0.370654257,0.370654257
Virginia,VA,Amelia County,51,7,51007,Cowboys,#002244,12903,2150,4704,7035,0.305614783,0.668656716,-2554,2554,-0.363041933,0.363041933
Virginia,VA,Amherst County,51,9,51009,Redskins,#773141,31914,4986,9643,15164,0.328805065,0.635914007,-4657,4657,-0.307108942,0.307108942
Virginia,VA,Appomattox County,51,11,51011,Cowboys,#002244,15414,2023,5714,7954,0.25433744,0.718380689,-3691,3691,-0.464043249,0.464043249
Virginia,VA,Arlington County,51,13,51013,Redskins,#773141,229164,91879,20155,119344,0.769866939,0.168881552,71724,-71724,0.600985387,-0.600985387
Virginia,VA,Augusta County,51,15,51015,Redskins,#773141,74314,8108,26152,36661,0.221161452,0.713346608,-18044,18044,-0.492185156,0.492185156
Virginia,VA,Bath County,51,17,51017,Cowboys,#002244,4470,603,1548,2243,0.26883638,0.690147124,-945,945,-0.421310745,0.421310745
Virginia,VA,Bedford County,51,19,51019,Redskins,#773141,77724,9733,30578,42186,0.230716351,0.724837624,-20845,20845,-0.494121272,0.494121272
Virginia,VA,Bland County,51,21,51021,Steelers,#ffb612,6561,453,2572,3124,0.145006402,0.823303457,-2119,2119,-0.678297055,0.678297055
Virginia,VA,Botetourt County,51,23,51023,Redskins,#773141,33347,4492,13369,18641,0.240974197,0.717182555,-8877,8877,-0.476208358,0.476208358
Virginia,VA,Brunswick County,51,25,51025,Cowboys,#002244,16698,4473,3045,7645,0.585088293,0.398299542,1428,-1428,0.186788751,-0.186788751
Virginia,VA,Buchanan County,51,27,51027,Steelers,#ffb612,22776,1721,7292,9220,0.186659436,0.790889371,-5571,5571,-0.604229935,0.604229935
Virginia,VA,Buckingham County,51,29,51029,Cowboys,#002244,17032,3128,3969,7284,0.429434377,0.544892916,-841,841,-0.115458539,0.115458539
Virginia,VA,Campbell County,51,31,51031,Cowboys,#002244,55086,6597,19442,27218,0.242376369,0.714306709,-12845,12845,-0.47193034,0.47193034
Virginia,VA,Caroline County,51,33,51033,Redskins,#773141,29984,6425,7143,14189,0.452815561,0.503418141,-718,718,-0.050602579,0.050602579
Virginia,VA,Carroll County,51,35,51035,Cowboys,#002244,29724,2557,10653,13587,0.188194598,0.784058291,-8096,8096,-0.595863693,0.595863693
Virginia,VA,Charles City County,51,36,51036,Cowboys,#002244,7040,2244,1381,3745,0.599198932,0.368758344,863,-863,0.230440587,-0.230440587
Virginia,VA,Charlotte County,51,37,51037,Cowboys,#002244,12201,2153,3479,5792,0.371719613,0.600656077,-1326,1326,-0.228936464,0.228936464
Virginia,VA,Chesterfield County,51,41,51041,Redskins,#773141,335687,80993,84938,175288,0.462056729,0.484562548,-3945,3945,-0.022505819,0.022505819
Virginia,VA,Clarke County,51,43,51043,Redskins,#773141,14363,3047,4657,8131,0.374738655,0.57274628,-1610,1610,-0.198007625,0.198007625
Virginia,VA,Craig County,51,45,51045,Cowboys,#002244,5211,541,2139,2784,0.194324713,0.768318966,-1598,1598,-0.573994253,0.573994253
Virginia,VA,Culpeper County,51,47,51047,Redskins,#773141,49432,7744,13341,22087,0.350613483,0.604020465,-5597,5597,-0.253406981,0.253406981
Virginia,VA,Cumberland County,51,49,51049,Cowboys,#002244,9719,2032,2693,4875,0.416820513,0.552410256,-661,661,-0.135589744,0.135589744
Virginia,VA,Dickenson County,51,51,51051,Steelers,#ffb612,15115,1335,4932,6405,0.208430913,0.770023419,-3597,3597,-0.561592506,0.561592506
Virginia,VA,Dinwiddie County,51,53,51053,Cowboys,#002244,27852,5765,7447,13533,0.425995714,0.55028449,-1682,1682,-0.124288776,0.124288776
Virginia,VA,Essex County,51,57,51057,Redskins,#773141,11130,2541,2657,5354,0.474598431,0.496264475,-116,116,-0.021666044,0.021666044
Virginia,VA,Fairfax County,51,59,51059,Redskins,#773141,1142234,354485,157837,542858,0.652997653,0.290751909,196648,-196648,0.362245744,-0.362245744
Virginia,VA,Fauquier County,51,61,51061,Redskins,#773141,68782,12960,22110,37124,0.349100312,0.595571598,-9150,9150,-0.246471285,0.246471285
Virginia,VA,Floyd County,51,63,51063,Cowboys,#002244,15651,2300,5289,7972,0.288509784,0.663447065,-2989,2989,-0.37493728,0.37493728
Virginia,VA,Fluvanna County,51,65,51065,Redskins,#773141,26235,5751,7018,13492,0.426252594,0.520160095,-1267,1267,-0.093907501,0.093907501
Virginia,VA,Franklin County,51,67,51067,Redskins,#773141,56264,7254,18560,26805,0.270621153,0.692408133,-11306,11306,-0.42178698,0.42178698
Virginia,VA,Frederick County,51,69,51069,Redskins,#773141,83199,11920,26069,40133,0.297012434,0.649565196,-14149,14149,-0.352552762,0.352552762
Virginia,VA,Giles County,51,71,51071,Cowboys,#002244,16708,1949,5930,8196,0.237798926,0.72352367,-3981,3981,-0.485724744,0.485724744
Virginia,VA,Gloucester County,51,73,51073,Redskins,#773141,37143,5399,13087,19524,0.276531448,0.670303217,-7688,7688,-0.393771768,0.393771768
Virginia,VA,Goochland County,51,75,51075,Redskins,#773141,22253,4884,8374,13930,0.350610194,0.6011486,-3490,3490,-0.250538406,0.250538406
Virginia,VA,Grayson County,51,77,51077,Cowboys,#002244,16012,1407,5593,7258,0.193855056,0.770597961,-4186,4186,-0.576742904,0.576742904
Virginia,VA,Greene County,51,79,51079,Redskins,#773141,19162,2923,5943,9503,0.307587078,0.625381458,-3020,3020,-0.317794381,0.317794381
Virginia,VA,Greensville County,51,81,51081,Cowboys,#002244,11885,2558,1737,4363,0.586293835,0.398120559,821,-821,0.188173275,-0.188173275
Virginia,VA,Halifax County,51,83,51083,Cowboys,#002244,35125,6890,9698,16946,0.406585625,0.572288446,-2808,2808,-0.165702821,0.165702821
Virginia,VA,Hanover County,51,85,51085,Redskins,#773141,103227,19360,39592,62313,0.310689583,0.635373036,-20232,20232,-0.324683453,0.324683453
Virginia,VA,Henrico County,51,87,51087,Redskins,#773141,325155,93615,59674,161966,0.577991677,0.368435351,33941,-33941,0.209556327,-0.209556327
Virginia,VA,Henry County,51,89,51089,Cowboys,#002244,51881,8199,15207,24029,0.341212701,0.632860294,-7008,7008,-0.291647592,0.291647592
Virginia,VA,Highland County,51,91,51091,Redskins,#773141,2214,371,958,1391,0.266714594,0.688713156,-587,587,-0.421998562,0.421998562
Virginia,VA,Isle of Wight County,51,93,51093,Redskins,#773141,36314,7673,11971,20481,0.37463991,0.584492945,-4298,4298,-0.209853035,0.209853035
Virginia,VA,James City County,51,95,51095,Redskins,#773141,73147,19091,21284,42737,0.446708941,0.498022791,-2193,2193,-0.05131385,0.05131385
Virginia,VA,King and Queen County,51,97,51097,Redskins,#773141,7158,1451,2059,3615,0.401383126,0.569571231,-608,608,-0.168188105,0.168188105
Virginia,VA,King George County,51,99,51099,Redskins,#773141,25515,4002,7338,11967,0.334419654,0.613186262,-3336,3336,-0.278766608,0.278766608
Virginia,VA,King William County,51,101,51101,Redskins,#773141,16269,2752,5963,9088,0.302816901,0.656139965,-3211,3211,-0.353323063,0.353323063
Virginia,VA,Lancaster County,51,103,51103,Redskins,#773141,10965,2862,3520,6599,0.433702076,0.533414154,-658,658,-0.099712078,0.099712078
Virginia,VA,Lee County,51,105,51105,Cowboys,#002244,24742,1627,7542,9353,0.173954881,0.806372287,-5915,5915,-0.632417406,0.632417406
Virginia,VA,Loudoun County,51,107,51107,Redskins,#773141,375629,99909,69633,180265,0.554234044,0.386281308,30276,-30276,0.167952736,-0.167952736
Virginia,VA,Louisa County,51,109,51109,Redskins,#773141,34602,6208,10507,17507,0.354601017,0.600159936,-4299,4299,-0.245558919,0.245558919
Virginia,VA,Lunenburg County,51,111,51111,Redskins,#773141,12299,2226,3206,5577,0.399139322,0.574861036,-980,980,-0.175721714,0.175721714
Virginia,VA,Madison County,51,113,51113,Redskins,#773141,13134,2202,4418,6934,0.317565619,0.637150274,-2216,2216,-0.319584655,0.319584655
Virginia,VA,Mathews County,51,115,51115,Redskins,#773141,8862,1563,3515,5292,0.295351474,0.664210128,-1952,1952,-0.368858655,0.368858655
Virginia,VA,Mecklenburg County,51,117,51117,Cowboys,#002244,31081,6571,8283,15177,0.432957765,0.545760032,-1712,1712,-0.112802267,0.112802267
Virginia,VA,Middlesex County,51,119,51119,Redskins,#773141,10606,2107,3668,5994,0.351518185,0.611945279,-1561,1561,-0.260427094,0.260427094
Virginia,VA,Montgomery County,51,121,51121,Redskins,#773141,97653,20015,19455,42695,0.468790256,0.455673967,560,-560,0.01311629,-0.01311629
Virginia,VA,Nelson County,51,125,51125,Redskins,#773141,14785,3677,4150,8247,0.4458591,0.50321329,-473,473,-0.057354189,0.057354189
Virginia,VA,New Kent County,51,127,51127,Redskins,#773141,20392,3545,8117,12163,0.2914577,0.667351805,-4572,4572,-0.375894105,0.375894105
Virginia,VA,Northampton County,51,131,51131,Redskins,#773141,12155,3255,2686,6134,0.530648843,0.437887186,569,-569,0.092761656,-0.092761656
Virginia,VA,Northumberland County,51,133,51133,Redskins,#773141,12232,2830,5089,8176,0.346135029,0.622431507,-2259,2259,-0.276296477,0.276296477
Virginia,VA,Nottoway County,51,135,51135,Redskins,#773141,15673,2829,3712,6717,0.421170165,0.552627661,-883,883,-0.131457496,0.131457496
Virginia,VA,Orange County,51,137,51137,Redskins,#773141,35385,5955,10511,17157,0.347088652,0.612636242,-4556,4556,-0.26554759,0.26554759
Virginia,VA,Page County,51,139,51139,Redskins,#773141,23726,2514,7824,10663,0.235768545,0.733752227,-5310,5310,-0.497983682,0.497983682
Virginia,VA,Patrick County,51,141,51141,Cowboys,#002244,18045,1768,6454,8489,0.208269525,0.760278007,-4686,4686,-0.552008482,0.552008482
Virginia,VA,Pittsylvania County,51,143,51143,Cowboys,#002244,62194,9195,21742,31687,0.290182094,0.686148894,-12547,12547,-0.3959668,0.3959668
Virginia,VA,Powhatan County,51,145,51145,Redskins,#773141,28031,4057,11875,16794,0.241574372,0.707097773,-7818,7818,-0.465523401,0.465523401
Virginia,VA,Prince Edward County,51,147,51147,Redskins,#773141,22952,4590,4099,9113,0.503676067,0.449796993,491,-491,0.053879074,-0.053879074
Virginia,VA,Prince George County,51,149,51149,Cowboys,#002244,37862,6419,9157,16140,0.397707559,0.567348203,-2738,2738,-0.169640644,0.169640644
Virginia,VA,Prince William County,51,153,51153,Redskins,#773141,451721,83093,54065,144854,0.573632761,0.373237881,29028,-29028,0.20039488,-0.20039488
Virginia,VA,Pulaski County,51,155,51155,Cowboys,#002244,34332,4170,10314,15112,0.275939651,0.68250397,-6144,6144,-0.40656432,0.40656432
Virginia,VA,Rappahannock County,51,157,51157,Redskins,#773141,7378,1741,2532,4444,0.391764176,0.569756976,-791,791,-0.177992799,0.177992799
Virginia,VA,Richmond County,51,159,51159,Redskins,#773141,8908,1347,2213,3651,0.368940016,0.606135305,-866,866,-0.237195289,0.237195289
Virginia,VA,Roanoke County,51,161,51161,Redskins,#773141,94409,16787,30857,50149,0.334742467,0.615306387,-14070,14070,-0.28056392,0.28056392
Virginia,VA,Rockbridge County,51,163,51163,Cowboys,#002244,22354,3506,6671,10685,0.328123538,0.624333177,-3165,3165,-0.29620964,0.29620964
Virginia,VA,Rockingham County,51,165,51165,Redskins,#773141,78593,9361,25269,36536,0.25621305,0.691619225,-15908,15908,-0.435406175,0.435406175
Virginia,VA,Russell County,51,167,51167,Steelers,#ffb612,27891,2328,9516,12195,0.190897909,0.780319803,-7188,7188,-0.589421894,0.589421894
Virginia,VA,Scott County,51,169,51169,Cowboys,#002244,22126,1579,8242,10055,0.1570363,0.819691696,-6663,6663,-0.662655395,0.662655395
Virginia,VA,Shenandoah County,51,171,51171,Redskins,#773141,43190,5269,14078,20335,0.259109909,0.69230391,-8809,8809,-0.433194,0.433194
Virginia,VA,Smyth County,51,173,51173,Cowboys,#002244,31470,2661,9747,12825,0.20748538,0.76,-7086,7086,-0.55251462,0.55251462
Virginia,VA,Southampton County,51,175,51175,Redskins,#773141,18109,3595,5035,8872,0.405207394,0.56751578,-1440,1440,-0.162308386,0.162308386
Virginia,VA,Spotsylvania County,51,177,51177,Redskins,#773141,130475,24204,34619,62083,0.38986518,0.55762447,-10415,10415,-0.16775929,0.16775929
Virginia,VA,Stafford County,51,179,51179,Redskins,#773141,142003,27879,33840,65350,0.426610559,0.517827085,-5961,5961,-0.091216526,0.091216526
Virginia,VA,Surry County,51,181,51181,Cowboys,#002244,6709,2069,1785,3976,0.520372233,0.448943662,284,-284,0.071428571,-0.071428571
Virginia,VA,Sussex County,51,183,51183,Cowboys,#002244,11715,2874,2055,5036,0.570691025,0.408061954,819,-819,0.162629071,-0.162629071
Virginia,VA,Tazewell County,51,185,51185,Steelers,#ffb612,42899,2895,15160,18495,0.156528792,0.819680995,-12265,12265,-0.663152203,0.663152203
Virginia,VA,Warren County,51,187,51187,Redskins,#773141,39083,5165,11762,17791,0.290315328,0.661120791,-6597,6597,-0.370805463,0.370805463
Virginia,VA,Washington County,51,191,51191,Steelers,#ffb612,54591,5548,19309,25715,0.215749563,0.750884698,-13761,13761,-0.535135135,0.535135135
Virginia,VA,Westmoreland County,51,193,51193,Redskins,#773141,17629,3723,4331,8291,0.449041129,0.522373658,-608,608,-0.073332529,0.073332529
Virginia,VA,Wise County,51,195,51195,Cowboys,#002244,39718,2687,11983,14991,0.179240878,0.799346274,-9296,9296,-0.620105397,0.620105397
Virginia,VA,Wythe County,51,197,51197,Cowboys,#002244,29119,2765,10044,13250,0.208679245,0.758037736,-7279,7279,-0.549358491,0.549358491
Virginia,VA,York County,51,199,51199,Redskins,#773141,67837,12989,18823,34062,0.381334038,0.552609947,-5834,5834,-0.171275909,0.171275909
Virginia,VA,Alexandria city,51,510,51510,Redskins,#773141,153511,57147,13241,74384,0.768270058,0.178008712,43906,-43906,0.590261347,-0.590261347
Virginia,VA,Bedford County,51,515,51515,Redskins,#773141,77724,9733,30578,42186,0.230716351,0.724837624,-20845,20845,-0.494121272,0.494121272
Virginia,VA,Bristol city,51,520,51520,Steelers,#ffb612,17141,1832,4884,6966,0.262991674,0.701119724,-3052,3052,-0.438128051,0.438128051
Virginia,VA,Buena Vista city,51,530,51530,Cowboys,#002244,6618,693,1432,2395,0.289352818,0.597912317,-739,739,-0.308559499,0.308559499
Virginia,VA,Charlottesville city,51,540,51540,Redskins,#773141,46597,17865,2951,22211,0.804331187,0.132862095,14914,-14914,0.671469092,-0.671469092
Virginia,VA,Chesapeake city,51,550,51550,Redskins,#773141,235429,52554,53988,111827,0.46995806,0.482781439,-1434,1434,-0.012823379,0.012823379
Virginia,VA,#N/A,51,560,51560,Redskins,#773141,#N/A,#N/A,#N/A,#N/A,#N/A,#N/A,#N/A,#N/A,#N/A,#N/A
Virginia,VA,Colonial Heights city,51,570,51570,Redskins,#773141,17820,2367,5681,8427,0.280882876,0.674142637,-3314,3314,-0.39325976,0.39325976
Virginia,VA,Covington city,51,580,51580,Cowboys,#002244,5658,914,1349,2369,0.3858168,0.569438582,-435,435,-0.183621781,0.183621781
Virginia,VA,Danville city,51,590,51590,Cowboys,#002244,42082,11051,7306,18862,0.585886969,0.387339625,3745,-3745,0.198547344,-0.198547344
Virginia,VA,Emporia city,51,595,51595,Cowboys,#002244,5496,1531,792,2367,0.646810308,0.33460076,739,-739,0.312209548,-0.312209548
Virginia,VA,Fairfax city,51,600,51600,Redskins,#773141,24013,7363,3695,11854,0.621140543,0.311709128,3668,-3668,0.309431416,-0.309431416
Virginia,VA,Falls Church city,51,610,51610,Redskins,#773141,13892,5810,1323,7667,0.757793139,0.172557715,4487,-4487,0.585235425,-0.585235425
Virginia,VA,Franklin city,51,620,51620,Redskins,#773141,8490,2516,1421,4040,0.622772277,0.351732673,1095,-1095,0.271039604,-0.271039604
Virginia,VA,Fredericksburg city,51,630,51630,Redskins,#773141,28118,6690,3731,11135,0.600808262,0.3350696,2959,-2959,0.265738662,-0.265738662
Virginia,VA,Galax city,51,640,51640,Cowboys,#002244,6914,680,1603,2363,0.287769784,0.678374947,-923,923,-0.390605163,0.390605163
Virginia,VA,Hampton city,51,650,51650,Cowboys,#002244,136454,41030,17802,61489,0.667273821,0.289515198,23228,-23228,0.377758623,-0.377758623
Virginia,VA,Harrisonburg city,51,660,51660,Redskins,#773141,52538,10100,6232,17693,0.570847228,0.352229695,3868,-3868,0.218617532,-0.218617532
Virginia,VA,Hopewell city,51,670,51670,Cowboys,#002244,22378,4722,3885,8968,0.526538805,0.433206958,837,-837,0.093331847,-0.093331847
Virginia,VA,Lexington city,51,678,51678,Redskins,#773141,7262,1514,766,2448,0.618464052,0.312908497,748,-748,0.305555556,-0.305555556
Virginia,VA,Lynchburg city,51,680,51680,Redskins,#773141,79812,14787,17979,35349,0.418314521,0.508614105,-3192,3192,-0.090299584,0.090299584
Virginia,VA,Manassas city,51,683,51683,Redskins,#773141,41764,8395,5934,15210,0.551939513,0.390138067,2461,-2461,0.161801446,-0.161801446
Virginia,VA,Manassas Park city,51,685,51685,Redskins,#773141,15726,3218,1732,5214,0.617184503,0.332182585,1486,-1486,0.285001918,-0.285001918
Virginia,VA,Martinsville city,51,690,51690,Cowboys,#002244,13645,3531,2149,5873,0.601225949,0.3659118,1382,-1382,0.235314149,-0.235314149
Virginia,VA,Newport News city,51,700,51700,Cowboys,#002244,182385,40997,23650,68432,0.599091069,0.34559855,17347,-17347,0.253492518,-0.253492518
Virginia,VA,Norfolk city,51,710,51710,Cowboys,#002244,246393,51429,19875,75172,0.684151014,0.264393657,31554,-31554,0.419757356,-0.419757356
Virginia,VA,Norton city,51,720,51720,Steelers,#ffb612,3939,383,1021,1456,0.263049451,0.701236264,-638,638,-0.438186813,0.438186813
Virginia,VA,Petersburg city,51,730,51730,Cowboys,#002244,32477,12005,1448,13717,0.875191368,0.105562441,10557,-10557,0.769628928,-0.769628928
Virginia,VA,Poquoson city,51,735,51735,Redskins,#773141,12059,1599,5089,7114,0.224768063,0.715350014,-3490,3490,-0.490581951,0.490581951
Virginia,VA,Portsmouth city,51,740,51740,Cowboys,#002244,96201,28462,12773,43000,0.661906977,0.297046512,15689,-15689,0.364860465,-0.364860465
Virginia,VA,Radford city,51,750,51750,Cowboys,#002244,17403,2923,2637,6032,0.484582228,0.437168435,286,-286,0.047413793,-0.047413793
Virginia,VA,Richmond city,51,760,51760,Redskins,#773141,220289,74640,14254,94724,0.787973481,0.150479287,60386,-60386,0.637494194,-0.637494194
Virginia,VA,Roanoke city,51,770,51770,Cowboys,#002244,99897,23403,16045,41728,0.560846434,0.384513995,7358,-7358,0.176332439,-0.176332439
Virginia,VA,Salem city,51,775,51775,Redskins,#773141,25432,4212,7225,12129,0.347266881,0.595679776,-3013,3013,-0.248412895,0.248412895
Virginia,VA,#N/A,51,780,51780,Redskins,#773141,#N/A,#N/A,#N/A,#N/A,#N/A,#N/A,#N/A,#N/A,#N/A,#N/A
Virginia,VA,Staunton city,51,790,51790,Redskins,#773141,24416,5329,5129,11144,0.478194544,0.460247667,200,-200,0.017946877,-0.017946877
Virginia,VA,Suffolk city,51,800,51800,Cowboys,#002244,88161,23012,17206,41929,0.54883255,0.410360371,5806,-5806,0.138472179,-0.138472179
Virginia,VA,Virginia Beach city,51,810,51810,Redskins,#773141,452745,76744,84389,171876,0.446507948,0.490987689,-7645,7645,-0.044479741,0.044479741
Virginia,VA,Waynesboro city,51,820,51820,Redskins,#773141,21491,3762,4798,9114,0.41277156,0.526442835,-1036,1036,-0.113671275,0.113671275
Virginia,VA,Williamsburg city,51,830,51830,Redskins,#773141,15052,5199,1921,7534,0.690071675,0.254977436,3278,-3278,0.435094239,-0.435094239
Virginia,VA,Winchester city,51,840,51840,Redskins,#773141,27284,5161,4786,10574,0.48808398,0.452619633,375,-375,0.035464347,-0.035464347
Washington,WA,Adams County,53,1,53001,Seahawks,#69be28,19254,1118,2740,4081,0.273952463,0.671404068,-1622,1622,-0.397451605,0.397451605
Washington,WA,Asotin County,53,3,53003,Seahawks,#69be28,22105,3118,5712,9684,0.321974391,0.58983891,-2594,2594,-0.267864519,0.267864519
Washington,WA,Benton County,53,5,53005,Seahawks,#69be28,190309,25173,45594,76907,0.327317409,0.592845905,-20421,20421,-0.265528495,0.265528495
Washington,WA,Chelan County,53,7,53007,Seahawks,#69be28,75644,10770,15070,27415,0.392850629,0.54969907,-4300,4300,-0.156848441,0.156848441
Washington,WA,Clallam County,53,9,53009,Seahawks,#69be28,73486,15154,15685,32985,0.459420949,0.475519175,-531,531,-0.016098226,0.016098226
Washington,WA,Clark County,53,11,53011,Seahawks,#69be28,459495,90697,90590,195784,0.463250317,0.462703796,107,-107,0.000546521,-0.000546521
Washington,WA,Columbia County,53,13,53013,Seahawks,#69be28,3944,523,1491,2171,0.24090281,0.686780286,-968,968,-0.445877476,0.445877476
Washington,WA,Cowlitz County,53,15,53015,Seahawks,#69be28,103468,17842,24066,45485,0.392261185,0.529097505,-6224,6224,-0.13683632,0.13683632
Washington,WA,Douglas County,53,17,53017,Seahawks,#69be28,40534,3600,7208,11467,0.313944362,0.628586378,-3608,3608,-0.314642016,0.314642016
Washington,WA,Ferry County,53,19,53019,Seahawks,#69be28,7582,1091,2178,3560,0.306460674,0.611797753,-1087,1087,-0.305337079,0.305337079
Washington,WA,Franklin County,53,21,53021,Seahawks,#69be28,88807,7839,11358,20584,0.380829771,0.551787796,-3519,3519,-0.170958026,0.170958026
Washington,WA,Garfield County,53,23,53023,Seahawks,#69be28,2219,276,841,1232,0.224025974,0.68262987,-565,565,-0.458603896,0.458603896
Washington,WA,Grant County,53,25,53025,Seahawks,#69be28,93259,7768,18482,28260,0.27487615,0.653998585,-10714,10714,-0.379122435,0.379122435
Washington,WA,Grays Harbor County,53,27,53027,Seahawks,#69be28,71122,11378,13269,26736,0.425568522,0.496297127,-1891,1891,-0.070728606,0.070728606
Washington,WA,Island County,53,29,53029,Seahawks,#69be28,80593,20766,18259,42425,0.489475545,0.430383029,2507,-2507,0.059092516,-0.059092516
Washington,WA,Jefferson County,53,31,53031,Seahawks,#69be28,30466,12556,5986,20100,0.624676617,0.297810945,6570,-6570,0.326865672,-0.326865672
Washington,WA,King County,53,33,53033,Seahawks,#69be28,2117125,657149,197781,910823,0.721489247,0.217145373,459368,-459368,0.504343874,-0.504343874
Washington,WA,Kitsap County,53,35,53035,Seahawks,#69be28,260131,60561,46762,118625,0.510524763,0.394200211,13799,-13799,0.116324552,-0.116324552
Washington,WA,Kittitas County,53,37,53037,Seahawks,#69be28,43269,7190,9845,18334,0.392167558,0.536980473,-2655,2655,-0.144812916,0.144812916
Washington,WA,Klickitat County,53,39,53039,Seahawks,#69be28,21026,3781,5390,9859,0.383507455,0.546708591,-1609,1609,-0.163201136,0.163201136
Washington,WA,Lewis County,53,41,53041,Seahawks,#69be28,75882,7236,16273,24995,0.2894979,0.65105021,-9037,9037,-0.36155231,0.36155231
Washington,WA,Lincoln County,53,43,53043,Seahawks,#69be28,10321,1238,4095,5692,0.217498243,0.71943078,-2857,2857,-0.501932537,0.501932537
Washington,WA,Mason County,53,45,53045,Seahawks,#69be28,61023,11872,13539,27767,0.427557892,0.487593186,-1667,1667,-0.060035294,0.060035294
Washington,WA,Okanogan County,53,47,53047,Seahawks,#69be28,41516,3980,6305,10893,0.365372257,0.578812081,-2325,2325,-0.213439824,0.213439824
Washington,WA,Pacific County,53,49,53049,Seahawks,#69be28,20848,4597,5338,10667,0.430955283,0.500421862,-741,741,-0.069466579,0.069466579
Washington,WA,Pend Oreille County,53,51,53051,Seahawks,#69be28,13088,1932,4364,6788,0.284619918,0.642899234,-2432,2432,-0.358279316,0.358279316
Washington,WA,Pierce County,53,53,53053,Seahawks,#69be28,843954,160306,136046,322592,0.496931108,0.421727755,24260,-24260,0.075203353,-0.075203353
Washington,WA,San Juan County,53,55,53055,Seahawks,#69be28,16252,7053,2651,10589,0.666068562,0.250354141,4402,-4402,0.415714421,-0.415714421
Washington,WA,Skagit County,53,57,53057,Seahawks,#69be28,121846,26076,24330,54831,0.475570389,0.443727089,1746,-1746,0.0318433,-0.0318433
Washington,WA,Skamania County,53,59,53059,Seahawks,#69be28,11339,2207,2910,5587,0.395024163,0.520851978,-703,703,-0.125827815,0.125827815
Washington,WA,Snohomish County,53,61,53061,Seahawks,#69be28,772501,167943,116433,309496,0.54263383,0.376201954,51510,-51510,0.166431876,-0.166431876
Washington,WA,Spokane County,53,63,53063,Seahawks,#69be28,490945,86590,103846,208081,0.416136024,0.499065268,-17256,17256,-0.082929244,0.082929244
Washington,WA,Stevens County,53,65,53065,Seahawks,#69be28,43791,4348,11059,16438,0.264509064,0.67277041,-6711,6711,-0.408261346,0.408261346
Washington,WA,Thurston County,53,67,53067,Seahawks,#69be28,269536,65015,46219,122301,0.53159827,0.377911873,18796,-18796,0.153686397,-0.153686397
Washington,WA,Wahkiakum County,53,69,53069,Seahawks,#69be28,4042,824,1328,2333,0.353193313,0.569224175,-504,504,-0.216030862,0.216030862
Washington,WA,Walla Walla County,53,71,53071,Seahawks,#69be28,60338,7550,10775,19718,0.382898874,0.546455016,-3225,3225,-0.163556142,0.163556142
Washington,WA,Whatcom County,53,73,53073,Seahawks,#69be28,212284,59402,40247,108223,0.548885172,0.371889524,19155,-19155,0.176995648,-0.176995648
Washington,WA,Whitman County,53,75,53075,Seahawks,#69be28,48177,5521,5462,12128,0.455227573,0.450362797,59,-59,0.004864776,-0.004864776
Washington,WA,Yakima County,53,77,53077,Seahawks,#69be28,248830,28484,39593,72306,0.393936879,0.547575582,-11109,11109,-0.153638702,0.153638702
West Virginia,WV,Barbour County,54,1,54001,Steelers,#ffb612,16704,1213,4509,6024,0.201361222,0.748505976,-3296,3296,-0.547144754,0.547144754
West Virginia,WV,Berkeley County,54,3,54003,Redskins,#773141,111901,12287,28210,42770,0.287280804,0.659574468,-15923,15923,-0.372293664,0.372293664
West Virginia,WV,Boone County,54,5,54005,Steelers,#ffb612,23372,1783,6483,8654,0.206031893,0.749133349,-4700,4700,-0.543101456,0.543101456
West Virginia,WV,Braxton County,54,7,54007,Steelers,#ffb612,14415,1315,3516,5063,0.259727434,0.694449931,-2201,2201,-0.434722497,0.434722497
West Virginia,WV,Brooke County,54,9,54009,Steelers,#ffb612,23350,2549,6574,9540,0.267190776,0.689098532,-4025,4025,-0.421907757,0.421907757
West Virginia,WV,Cabell County,54,11,54011,Steelers,#ffb612,96844,11306,19648,32701,0.345738662,0.600837895,-8342,8342,-0.255099232,0.255099232
West Virginia,WV,Calhoun County,54,13,54013,Steelers,#ffb612,7470,456,2023,2604,0.175115207,0.77688172,-1567,1567,-0.601766513,0.601766513
West Virginia,WV,Clay County,54,15,54015,Steelers,#ffb612,8910,566,2289,2958,0.191345504,0.773833671,-1723,1723,-0.582488168,0.582488168
West Virginia,WV,Doddridge County,54,17,54017,Steelers,#ffb612,8176,360,2347,2826,0.127388535,0.830502477,-1987,1987,-0.703113942,0.703113942
West Virginia,WV,Fayette County,54,19,54019,Steelers,#ffb612,44997,4246,10263,15187,0.279581221,0.675775334,-6017,6017,-0.396194113,0.396194113
West Virginia,WV,Gilmer County,54,21,54021,Steelers,#ffb612,8518,537,1889,2528,0.212420886,0.747231013,-1352,1352,-0.534810127,0.534810127
West Virginia,WV,Grant County,54,23,54023,Steelers,#ffb612,11766,510,4338,4945,0.103134479,0.877249747,-3828,3828,-0.774115268,0.774115268
West Virginia,WV,Greenbrier County,54,25,54025,Steelers,#ffb612,35516,3743,9499,13984,0.267663043,0.679276316,-5756,5756,-0.411613272,0.411613272
West Virginia,WV,Hampshire County,54,27,54027,Steelers,#ffb612,23353,1576,6646,8557,0.184176697,0.776674068,-5070,5070,-0.592497371,0.592497371
West Virginia,WV,Hancock County,54,29,54029,Steelers,#ffb612,29815,3247,8870,12642,0.256842272,0.701629489,-5623,5623,-0.444787217,0.444787217
West Virginia,WV,Hardy County,54,31,54031,Steelers,#ffb612,13852,1249,4544,6022,0.207406177,0.754566589,-3295,3295,-0.547160412,0.547160412
West Virginia,WV,Harrison County,54,33,54033,Steelers,#ffb612,68714,7675,18687,27868,0.275405483,0.67055404,-11012,11012,-0.395148557,0.395148557
West Virginia,WV,Jackson County,54,35,54035,Steelers,#ffb612,29237,2648,8959,12108,0.218698381,0.739924017,-6311,6311,-0.521225636,0.521225636
West Virginia,WV,Jefferson County,54,37,54037,Redskins,#773141,56482,9458,13144,24007,0.393968426,0.547506977,-3686,3686,-0.153538551,0.153538551
West Virginia,WV,Kanawha County,54,39,54039,Steelers,#ffb612,188332,27985,43464,74996,0.373153235,0.579550909,-15479,15479,-0.206397675,0.206397675
West Virginia,WV,Lewis County,54,41,54041,Steelers,#ffb612,16448,1336,5245,6885,0.194045025,0.761801017,-3909,3909,-0.567755991,0.567755991
West Virginia,WV,Lincoln County,54,43,54043,Steelers,#ffb612,21415,1435,5257,6988,0.205352032,0.752289639,-3822,3822,-0.546937607,0.546937607
West Virginia,WV,Logan County,54,45,54045,Steelers,#ffb612,34707,2082,9866,12315,0.169062119,0.801136825,-7784,7784,-0.632074706,0.632074706
West Virginia,WV,McDowell County,54,47,54047,Steelers,#ffb612,19835,1429,4614,6179,0.231267195,0.746722771,-3185,3185,-0.515455575,0.515455575
West Virginia,WV,Marion County,54,49,54049,Steelers,#ffb612,56925,6926,14592,22910,0.3023134,0.636927106,-7666,7666,-0.334613706,0.334613706
West Virginia,WV,Marshall County,54,51,54051,Steelers,#ffb612,31978,2894,9565,13083,0.221203088,0.731101429,-6671,6671,-0.509898341,0.509898341
West Virginia,WV,Mason County,54,53,54053,Steelers,#ffb612,27037,2069,7597,10115,0.204547701,0.751062778,-5528,5528,-0.546515077,0.546515077
West Virginia,WV,Mercer County,54,55,54055,Steelers,#ffb612,61164,4689,17362,22919,0.204590078,0.757537414,-12673,12673,-0.552947336,0.552947336
West Virginia,WV,Mineral County,54,57,54057,Steelers,#ffb612,27451,2019,8957,11410,0.176950044,0.785013146,-6938,6938,-0.608063103,0.608063103
West Virginia,WV,Mingo County,54,59,54059,Steelers,#ffb612,25292,1365,7876,9469,0.14415461,0.831766818,-6511,6511,-0.687612208,0.687612208
West Virginia,WV,Monongalia County,54,61,54061,Steelers,#ffb612,104236,14568,18278,35733,0.40769037,0.511515966,-3710,3710,-0.103825595,0.103825595
West Virginia,WV,Monroe County,54,63,54063,Steelers,#ffb612,13506,1089,4337,5670,0.192063492,0.764902998,-3248,3248,-0.572839506,0.572839506
West Virginia,WV,Morgan County,54,65,54065,Steelers,#ffb612,17524,1568,5718,7635,0.205370007,0.74891945,-4150,4150,-0.543549443,0.543549443
West Virginia,WV,Nicholas County,54,67,54067,Steelers,#ffb612,25594,1821,7169,9385,0.194033031,0.76387853,-5348,5348,-0.569845498,0.569845498
West Virginia,WV,Ohio County,54,69,54069,Steelers,#ffb612,43066,5452,11077,17819,0.305965542,0.621639823,-5625,5625,-0.31567428,0.31567428
West Virginia,WV,Pendleton County,54,71,54071,Steelers,#ffb612,7229,726,2388,3212,0.226027397,0.743462017,-1662,1662,-0.51743462,0.51743462
West Virginia,WV,Pleasants County,54,73,54073,Steelers,#ffb612,7674,620,2342,3130,0.198083067,0.748242812,-1722,1722,-0.550159744,0.550159744
West Virginia,WV,Pocahontas County,54,75,54075,Steelers,#ffb612,8607,924,2474,3619,0.255319149,0.683614258,-1550,1550,-0.428295109,0.428295109
West Virginia,WV,Preston County,54,77,54077,Steelers,#ffb612,33940,2462,9501,12611,0.19522639,0.753389898,-7039,7039,-0.558163508,0.558163508
West Virginia,WV,Putnam County,54,79,54079,Steelers,#ffb612,56848,5784,17455,24443,0.236632165,0.714110379,-11671,11671,-0.477478215,0.477478215
West Virginia,WV,Raleigh County,54,81,54081,Steelers,#ffb612,77510,6362,21835,29311,0.217051619,0.744942172,-15473,15473,-0.527890553,0.527890553
West Virginia,WV,Randolph County,54,83,54083,Steelers,#ffb612,29126,2724,7583,10816,0.251849112,0.701090976,-4859,4859,-0.449241864,0.449241864
West Virginia,WV,Ritchie County,54,85,54085,Steelers,#ffb612,9982,490,3376,4040,0.121287129,0.835643564,-2886,2886,-0.714356436,0.714356436
West Virginia,WV,Roane County,54,87,54087,Steelers,#ffb612,14435,1220,3772,5234,0.233091326,0.720672526,-2552,2552,-0.4875812,0.4875812
West Virginia,WV,Summers County,54,89,54089,Steelers,#ffb612,13239,1186,3444,4847,0.244687436,0.710542604,-2258,2258,-0.465855168,0.465855168
West Virginia,WV,Taylor County,54,91,54091,Steelers,#ffb612,16912,1483,4701,6498,0.228224069,0.72345337,-3218,3218,-0.495229301,0.495229301
West Virginia,WV,Tucker County,54,93,54093,Steelers,#ffb612,6966,750,2557,3464,0.216512702,0.738163972,-1807,1807,-0.52165127,0.52165127
West Virginia,WV,Tyler County,54,95,54095,Steelers,#ffb612,8975,505,2967,3621,0.139464236,0.81938691,-2462,2462,-0.679922673,0.679922673
West Virginia,WV,Upshur County,54,97,54097,Steelers,#ffb612,24758,1763,6971,9180,0.19204793,0.759368192,-5208,5208,-0.567320261,0.567320261
West Virginia,WV,Wayne County,54,99,54099,Steelers,#ffb612,40971,3334,11077,15080,0.221087533,0.734549072,-7743,7743,-0.513461538,0.513461538
West Virginia,WV,Webster County,54,101,54101,Steelers,#ffb612,8755,554,2284,2955,0.187478849,0.772927242,-1730,1730,-0.585448393,0.585448393
West Virginia,WV,Wetzel County,54,103,54103,Steelers,#ffb612,15816,1348,4461,6191,0.217735422,0.720562106,-3113,3113,-0.502826684,0.502826684
West Virginia,WV,Wirt County,54,105,54105,Steelers,#ffb612,5880,383,1903,2410,0.158921162,0.789626556,-1520,1520,-0.630705394,0.630705394
West Virginia,WV,Wood County,54,107,54107,Steelers,#ffb612,86452,8327,25168,35256,0.236186748,0.713864307,-16841,16841,-0.477677558,0.477677558
West Virginia,WV,Wyoming County,54,109,54109,Steelers,#ffb612,22151,1061,6527,7809,0.135868869,0.835830452,-5466,5466,-0.699961583,0.699961583
Wisconsin,WI,Adams County,55,1,55001,Packers,#203731,20148,3780,5983,10107,0.373998219,0.591965964,-2203,2203,-0.217967745,0.217967745
Wisconsin,WI,Ashland County,55,3,55003,Packers,#203731,15843,4136,3428,7926,0.521826899,0.432500631,708,-708,0.089326268,-0.089326268
Wisconsin,WI,Barron County,55,5,55005,Packers,#203731,45563,7881,13595,22514,0.350048858,0.603846496,-5714,5714,-0.253797637,0.253797637
Wisconsin,WI,Bayfield County,55,7,55007,Packers,#203731,14977,4953,4125,9491,0.521862817,0.434622274,828,-828,0.087240544,-0.087240544
Wisconsin,WI,Brown County,55,9,55009,Packers,#203731,258718,53358,67192,127497,0.418503965,0.527008479,-13834,13834,-0.108504514,0.108504514
Wisconsin,WI,Buffalo County,55,11,55011,Packers,#203731,13192,2531,4049,6921,0.365698598,0.585031065,-1518,1518,-0.219332466,0.219332466
Wisconsin,WI,Burnett County,55,13,55013,Packers,#203731,15159,2948,5412,8719,0.338112169,0.620713385,-2464,2464,-0.282601216,0.282601216
Wisconsin,WI,Calumet County,55,15,55015,Packers,#203731,49762,9634,15345,26429,0.364523819,0.580612206,-5711,5711,-0.216088388,0.216088388
Wisconsin,WI,Chippewa County,55,17,55017,Packers,#203731,63531,11875,17912,31471,0.377331512,0.569158908,-6037,6037,-0.191827397,0.191827397
Wisconsin,WI,Clark County,55,19,55019,Packers,#203731,34445,4225,8645,13548,0.311854148,0.638101565,-4420,4420,-0.326247417,0.326247417
Wisconsin,WI,Columbia County,55,21,55021,Packers,#203731,56743,13525,14160,29287,0.461808994,0.483490969,-635,635,-0.021681975,0.021681975
Wisconsin,WI,Crawford County,55,23,55023,Packers,#203731,16391,3426,3844,7678,0.446209951,0.500651211,-418,418,-0.054441261,0.054441261
Wisconsin,WI,Dane County,55,25,55025,Packers,#203731,523643,217506,71270,304729,0.713768627,0.233879939,146236,-146236,0.479888688,-0.479888688
Wisconsin,WI,Dodge County,55,27,55027,Packers,#203731,88502,13968,26643,42818,0.326217946,0.622238311,-12675,12675,-0.296020365,0.296020365
Wisconsin,WI,Door County,55,29,55029,Packers,#203731,27554,8026,8584,17398,0.461317393,0.493390045,-558,558,-0.032072652,0.032072652
Wisconsin,WI,Douglas County,55,31,55031,Packers,#203731,43601,11342,9657,22185,0.511246338,0.435294118,1685,-1685,0.07595222,-0.07595222
Wisconsin,WI,Dunn County,55,33,55033,Packers,#203731,44497,9025,11487,22029,0.40968723,0.521448999,-2462,2462,-0.111761769,0.111761769
Wisconsin,WI,Eau Claire County,55,35,55035,Packers,#203731,102105,27271,23301,54080,0.50427145,0.430861686,3970,-3970,0.073409763,-0.073409763
Wisconsin,WI,Florence County,55,37,55037,Packers,#203731,4464,666,1897,2651,0.251225952,0.715579027,-1231,1231,-0.464353074,0.464353074
Wisconsin,WI,Fond du Lac County,55,39,55039,Packers,#203731,101973,17391,31044,51094,0.340372646,0.607586018,-13653,13653,-0.267213371,0.267213371
Wisconsin,WI,Forest County,55,41,55041,Packers,#203731,9057,1583,2787,4507,0.351231418,0.618371422,-1204,1204,-0.267140004,0.267140004
Wisconsin,WI,Grant County,55,43,55043,Packers,#203731,52250,10047,12347,24051,0.417737308,0.513367428,-2300,2300,-0.095630119,0.095630119
Wisconsin,WI,Green County,55,45,55045,Packers,#203731,37186,9121,8693,18791,0.485391943,0.462615082,428,-428,0.022776861,-0.022776861
Wisconsin,WI,Green Lake County,55,47,55047,Packers,#203731,18856,2700,6210,9315,0.289855072,0.666666667,-3510,3510,-0.376811594,0.376811594
Wisconsin,WI,Iowa County,55,49,55049,Packers,#203731,23813,6669,4809,12123,0.550111359,0.396683989,1860,-1860,0.153427369,-0.153427369
Wisconsin,WI,Iron County,55,51,55051,Packers,#203731,5794,1273,2090,3477,0.366120219,0.601092896,-817,817,-0.234972678,0.234972678
Wisconsin,WI,Jackson County,55,53,55053,Packers,#203731,20554,3821,4907,9202,0.415235818,0.533253641,-1086,1086,-0.118017822,0.118017822
Wisconsin,WI,Jefferson County,55,55,55055,Packers,#203731,84559,16559,23409,42324,0.391243739,0.553090445,-6850,6850,-0.161846706,0.161846706
Wisconsin,WI,Juneau County,55,57,55057,Packers,#203731,26224,4100,7188,11736,0.34935242,0.612474438,-3088,3088,-0.263122018,0.263122018
Wisconsin,WI,Kenosha County,55,59,55059,Packers,#203731,168437,35770,36025,75825,0.471744148,0.475107155,-255,255,-0.003363007,0.003363007
Wisconsin,WI,Kewaunee County,55,61,55061,Packers,#203731,20366,3623,6616,10742,0.337274251,0.615900205,-2993,2993,-0.278625954,0.278625954
Wisconsin,WI,La Crosse County,55,63,55063,Packers,#203731,118212,32402,26384,62785,0.516078681,0.420227761,6018,-6018,0.09585092,-0.09585092
Wisconsin,WI,Lafayette County,55,65,55065,Packers,#203731,16829,3288,3977,7602,0.432517758,0.523151802,-689,689,-0.090634044,0.090634044
Wisconsin,WI,Langlade County,55,67,55067,Packers,#203731,19223,3260,6436,10093,0.322996136,0.637669672,-3176,3176,-0.314673536,0.314673536
Wisconsin,WI,Lincoln County,55,69,55069,Packers,#203731,27980,5370,8400,14563,0.368742704,0.57680423,-3030,3030,-0.208061526,0.208061526
Wisconsin,WI,Manitowoc County,55,71,55071,Packers,#203731,79806,14563,23234,39991,0.364156935,0.580980721,-8671,8671,-0.216823785,0.216823785
Wisconsin,WI,Marathon County,55,73,55073,Packers,#203731,135868,26476,39010,68849,0.3845517,0.566602275,-12534,12534,-0.182050574,0.182050574
Wisconsin,WI,Marinette County,55,75,55075,Packers,#203731,40884,6243,12995,19979,0.312478102,0.650432955,-6752,6752,-0.337954853,0.337954853
Wisconsin,WI,Marquette County,55,77,55077,Packers,#203731,15075,2808,4712,7813,0.359400998,0.603097402,-1904,1904,-0.243696403,0.243696403
Wisconsin,WI,Menominee County,55,78,55078,Packers,#203731,4573,1003,269,1279,0.784206411,0.210320563,734,-734,0.573885848,-0.573885848
Wisconsin,WI,Milwaukee County,55,79,55079,Packers,#203731,957735,288986,126091,434970,0.664381452,0.28988436,162895,-162895,0.374497092,-0.374497092
Wisconsin,WI,Monroe County,55,81,55081,Packers,#203731,45549,7047,11442,19554,0.360386622,0.585148819,-4395,4395,-0.224762197,0.224762197
Wisconsin,WI,Oconto County,55,83,55083,Packers,#203731,37435,5886,13255,19924,0.295422606,0.665278057,-7369,7369,-0.369855451,0.369855451
Wisconsin,WI,Oneida County,55,85,55085,Packers,#203731,35567,8103,11677,20837,0.388875558,0.56039737,-3574,3574,-0.171521812,0.171521812
Wisconsin,WI,Outagamie County,55,87,55087,Packers,#203731,183245,38117,51579,95162,0.400548538,0.542012568,-13462,13462,-0.14146403,0.14146403
Wisconsin,WI,Ozaukee County,55,89,55089,Packers,#203731,87850,20167,30458,53368,0.377885624,0.570716534,-10291,10291,-0.19283091,0.19283091
Wisconsin,WI,Pepin County,55,91,55091,Packers,#203731,7290,1345,2228,3746,0.359049653,0.594767752,-883,883,-0.235718099,0.235718099
Wisconsin,WI,Pierce County,55,93,55093,Packers,#203731,40889,8380,11260,21089,0.397363554,0.53392764,-2880,2880,-0.136564086,0.136564086
Wisconsin,WI,Polk County,55,95,55095,Packers,#203731,43441,7568,13864,22691,0.333524305,0.610991142,-6296,6296,-0.277466837,0.277466837
Wisconsin,WI,Portage County,55,97,55097,Packers,#203731,70408,18524,17310,38123,0.4859009,0.454056606,1214,-1214,0.031844293,-0.031844293
Wisconsin,WI,Price County,55,99,55099,Packers,#203731,13645,2671,4562,7560,0.353306878,0.603439153,-1891,1891,-0.250132275,0.250132275
Wisconsin,WI,Racine County,55,101,55101,Packers,#203731,195080,42506,46620,93678,0.45374581,0.497662205,-4114,4114,-0.043916394,0.043916394
Wisconsin,WI,Richland County,55,103,55103,Packers,#203731,17495,3577,4021,7962,0.44925898,0.505023863,-444,444,-0.055764883,0.055764883
Wisconsin,WI,Rock County,55,105,55105,Packers,#203731,161448,39336,31483,75043,0.52417947,0.419532801,7853,-7853,0.104646669,-0.104646669
Wisconsin,WI,Rusk County,55,107,55107,Packers,#203731,14124,2171,4564,7029,0.308863281,0.649310001,-2393,2393,-0.340446721,0.340446721
Wisconsin,WI,St. Croix County,55,109,55109,Packers,#203731,87513,17496,26123,46819,0.37369444,0.55795724,-8627,8627,-0.184262799,0.184262799
Wisconsin,WI,Sauk County,55,111,55111,Packers,#203731,63642,16050,15871,33848,0.474178681,0.468890333,179,-179,0.005288348,-0.005288348
Wisconsin,WI,Sawyer County,55,113,55113,Packers,#203731,16376,2846,4625,7767,0.366422042,0.595468006,-1779,1779,-0.229045964,0.229045964
Wisconsin,WI,Shawano County,55,115,55115,Packers,#203731,41304,6056,12742,19697,0.307457989,0.646900543,-6686,6686,-0.339442555,0.339442555
Wisconsin,WI,Sheboygan County,55,117,55117,Packers,#203731,115569,22636,32368,58290,0.388334191,0.555292503,-9732,9732,-0.166958312,0.166958312
Wisconsin,WI,Taylor County,55,119,55119,Packers,#203731,20455,2398,6589,9417,0.254645853,0.699692046,-4191,4191,-0.445046193,0.445046193
Wisconsin,WI,Trempealeau County,55,121,55121,Packers,#203731,29550,5645,7370,13581,0.415654223,0.542669906,-1725,1725,-0.127015684,0.127015684
Wisconsin,WI,Vernon County,55,123,55123,Packers,#203731,30506,6351,6994,14193,0.447474107,0.49277813,-643,643,-0.045304023,0.045304023
Wisconsin,WI,Vilas County,55,125,55125,Packers,#203731,21387,4769,8169,13453,0.354493422,0.607225154,-3400,3400,-0.252731733,0.252731733
Wisconsin,WI,Walworth County,55,127,55127,Packers,#203731,102804,18706,28848,50570,0.369903105,0.570456793,-10142,10142,-0.200553688,0.200553688
Wisconsin,WI,Washburn County,55,129,55129,Packers,#203731,15552,3283,5404,9059,0.362402031,0.596533834,-2121,2121,-0.234131803,0.234131803
Wisconsin,WI,Washington County,55,131,55131,Packers,#203731,133674,20854,51729,76246,0.27350943,0.678448706,-30875,30875,-0.404939276,0.404939276
Wisconsin,WI,Waukesha County,55,133,55133,Packers,#203731,396488,79199,145519,236269,0.335206904,0.615903906,-66320,66320,-0.280697002,0.280697002
Wisconsin,WI,Waupaca County,55,135,55135,Packers,#203731,51945,8303,16013,25491,0.325722804,0.628182496,-7710,7710,-0.302459692,0.302459692
Wisconsin,WI,Waushara County,55,137,55137,Packers,#203731,24033,3802,7669,11961,0.317866399,0.641167126,-3867,3867,-0.323300727,0.323300727
Wisconsin,WI,Winnebago County,55,139,55139,Packers,#203731,169546,37054,43447,85892,0.431402226,0.505832906,-6393,6393,-0.07443068,0.07443068
Wisconsin,WI,Wood County,55,141,55141,Packers,#203731,73435,14232,21502,37712,0.377386508,0.570163343,-7270,7270,-0.192776835,0.192776835
Wyoming,WY,Albany County,56,1,56001,Broncos,#fb4f14,37956,6888,7601,16420,0.419488429,0.462911084,-713,713,-0.043422655,0.043422655
Wyoming,WY,Big Horn County,56,3,56003,Broncos,#fb4f14,12022,594,4067,5079,0.116952156,0.800748179,-3473,3473,-0.683796023,0.683796023
Wyoming,WY,Campbell County,56,5,56005,Broncos,#fb4f14,49220,1324,15778,17935,0.073822135,0.879732367,-14454,14454,-0.805910231,0.805910231
Wyoming,WY,Carbon County,56,7,56007,Broncos,#fb4f14,15559,1279,4409,6200,0.206290323,0.711129032,-3130,3130,-0.50483871,0.50483871
Wyoming,WY,Converse County,56,9,56009,Broncos,#fb4f14,14236,668,5520,6552,0.101953602,0.842490842,-4852,4852,-0.740537241,0.740537241
Wyoming,WY,Crook County,56,11,56011,Broncos,#fb4f14,7444,271,3347,3771,0.071864227,0.887562981,-3076,3076,-0.815698754,0.815698754
Wyoming,WY,Fremont County,56,13,56013,Broncos,#fb4f14,40315,4200,11167,16543,0.253883818,0.675028713,-6967,6967,-0.421144895,0.421144895
Wyoming,WY,Goshen County,56,15,56015,Broncos,#fb4f14,13383,924,4418,5708,0.161878066,0.774001402,-3494,3494,-0.612123336,0.612123336
Wyoming,WY,Hot Springs County,56,17,56017,Broncos,#fb4f14,4741,400,1939,2535,0.157790927,0.764891519,-1539,1539,-0.607100592,0.607100592
Wyoming,WY,Johnson County,56,19,56019,Broncos,#fb4f14,8585,638,3477,4349,0.146700391,0.799494137,-2839,2839,-0.652793746,0.652793746
Wyoming,WY,Laramie County,56,21,56021,Broncos,#fb4f14,97121,11572,24844,39945,0.289698335,0.621955188,-13272,13272,-0.332256853,0.332256853
Wyoming,WY,Lincoln County,56,23,56023,Broncos,#fb4f14,18722,1105,6779,8398,0.131578947,0.807216004,-5674,5674,-0.675637056,0.675637056
Wyoming,WY,Natrona County,56,25,56025,Broncos,#fb4f14,82178,6573,23523,32493,0.202289724,0.723940541,-16950,16950,-0.521650817,0.521650817
Wyoming,WY,Niobrara County,56,27,56027,Broncos,#fb4f14,2542,115,1116,1297,0.088666153,0.860447186,-1001,1001,-0.771781033,0.771781033
Wyoming,WY,Park County,56,29,56029,Broncos,#fb4f14,29228,2535,11115,14634,0.173226732,0.759532595,-8580,8580,-0.586305863,0.586305863
Wyoming,WY,Platte County,56,31,56031,Broncos,#fb4f14,8812,719,3437,4460,0.161210762,0.770627803,-2718,2718,-0.60941704,0.60941704
Wyoming,WY,Sheridan County,56,33,56033,Broncos,#fb4f14,30009,2926,10266,14187,0.206245154,0.723620216,-7340,7340,-0.517375062,0.517375062
Wyoming,WY,Sublette County,56,35,56035,Broncos,#fb4f14,9899,644,3409,4297,0.149872004,0.793344194,-2765,2765,-0.64347219,0.64347219
Wyoming,WY,Sweetwater County,56,37,56037,Broncos,#fb4f14,44626,3233,12153,16661,0.194045976,0.729428006,-8920,8920,-0.53538203,0.53538203
Wyoming,WY,Teton County,56,39,56039,Broncos,#fb4f14,23125,7313,3920,12176,0.600607753,0.321944809,3393,-3393,0.278662943,-0.278662943
Wyoming,WY,Uinta County,56,41,56041,Broncos,#fb4f14,20822,1202,6154,8053,0.149261145,0.764187259,-4952,4952,-0.614926114,0.614926114
Wyoming,WY,Washakie County,56,43,56043,Broncos,#fb4f14,8328,532,2911,3715,0.14320323,0.783580081,-2379,2379,-0.640376851,0.640376851
Wyoming,WY,Weston County,56,45,56045,Broncos,#fb4f14,7234,294,2898,3334,0.088182364,0.869226155,-2604,2604,-0.781043791,0.781043791